 	スペース
!	カンタンフ
"	クォーテーション
#	シャープ
$	ドル
%	パーセント
&	アンド
'	アポストロフィ
(	カッコ
)	トジカッコ
*	アスタリスク
+	プラス
,	コンマ
-	マイナス
.	ピリオド
/	スラッシュ
0	ゼロ
1	イチ
2	ニ
3	サン
4	ヨン
5	ゴ
6	ロク
7	ナナ
8	ハチ
9	キュウ
:	コロン
;	セミコロン
<	ショウナリ
=	イコール
>	ダイナリ
?	クエスチョン
@	アットマーク
A	エイ アニマル
B	ビー ボーイ
C	シー キャット
D	ディー デスク
E	イー エッグ
F	エフ フレンド
G	ジー ゴルフ
H	エイチ ホテル
I	アイ インク
J	ジェイ ジャパン
K	ケイ キッチン
L	エル ラブ
M	エム マイク
N	エヌ ノベンバー
O	オー オープン
P	ピー パパ
Q	キュー クエスチョン
R	アール ルーム
S	エス スポーツ
T	ティー タイム
U	ユー ユージュアリー
V	ブイ ビデオ
W	ダブリュー ウィンドウ
X	エックス エックスセン
Y	ワイ ヤング
Z	ゼット ズー
[	カクカッコ
\	エンマーク
]	トジカクカッコ
^	ベキジョウ
_	アンダーライン
`	アクサングラーブ
a	エイ アニマル
b	ビー ボーイ
c	シー キャット
d	ディー デスク
e	イー エッグ
f	エフ フレンド
g	ジー ゴルフ
h	エイチ ホテル
i	アイ インク
j	ジェイ ジャパン
k	ケイ キッチン
l	エル ラブ
m	エム マイク
n	エヌ ノベンバー
o	オー オープン
p	ピー パパ
q	キュー クエスチョン
r	アール ルーム
s	エス スポーツ
t	ティー タイム
u	ユー ユージュアリー
v	ブイ ビデオ
w	ダブリュー ウィンドウ
x	エックス エックスセン
y	ワイ ヤング
z	ゼット ズー
{	チュウカッコ
|	タテボウ
}	トジチュウカッコ
~	チルダ
§	セクション
¨	ウムラウト
°	ド
±	プラスマイナス
´	アクサンテギュ
¶	ダンラクキゴウ
×	カケル
÷	ワル
Α	ギリシャ アルファ
Β	ギリシャ ベータ
Γ	ギリシャ ガンマ
Δ	ギリシャ デルタ
Ε	ギリシャ イプシロン
Ζ	ギリシャ ゼータ
Η	ギリシャ イータ
Θ	ギリシャ シータ
Ι	ギリシャ イオタ
Κ	ギリシャ カッパ
Λ	ギリシャ ラムダ
Μ	ギリシャ ミュー
Ν	ギリシャ ニュー
Ξ	ギリシャ グザイ
Ο	ギリシャ オミクロン
Π	ギリシャ パイ
Ρ	ギリシャ ロー
Σ	ギリシャ シグマ
Τ	ギリシャ タウ
Υ	ギリシャ ウプシロン
Φ	ギリシャ ファイ
Χ	ギリシャ カイ
Ψ	ギリシャ プサイ
Ω	ギリシャ オメガ
α	ギリシャ アルファ
β	ギリシャ ベータ
γ	ギリシャ ガンマ
δ	ギリシャ デルタ
ε	ギリシャ イプシロン
ζ	ギリシャ ゼータ
η	ギリシャ イータ
θ	ギリシャ シータ
ι	ギリシャ イオタ
κ	ギリシャ カッパ
λ	ギリシャ ラムダ
μ	ギリシャ ミュー
ν	ギリシャ ニュー
ξ	ギリシャ グザイ
ο	ギリシャ オミクロン
π	ギリシャ パイ
ρ	ギリシャ ロー
σ	ギリシャ シグマ
τ	ギリシャ タウ
υ	ギリシャ ウプシロン
φ	ギリシャ ファイ
χ	ギリシャ カイ
ψ	ギリシャ プサイ
ω	ギリシャ オメガ
Ё	キリル ィヨー
А	キリル アー
Б	キリル ベー
В	キリル ヴェー
Г	キリル ゲー
Д	キリル デー
Е	キリル ィエー
Ж	キリル ジェー
З	キリル ゼー
И	キリル イー
Й	キリル イークラトコエ
К	キリル カー
Л	キリル エル
М	キリル エム
Н	キリル エヌ
О	キリル オー
П	キリル ペー
Р	キリル エル
С	キリル エス
Т	キリル テー
У	キリル ウー
Ф	キリル エフ
Х	キリル ハー
Ц	キリル ツェー
Ч	キリル チェー
Ш	キリル シャー
Щ	キリル シシャー
Ъ	キリル コウオンキゴウ
Ы	キリル ウィ
Ь	キリル ナンオンキゴウ
Э	キリル エー
Ю	キリル ユー
Я	キリル ヤー
а	キリル アー
б	キリル ベー
в	キリル ヴェー
г	キリル ゲー
д	キリル デー
е	キリル ィエー
ж	キリル ジェー
з	キリル ゼー
и	キリル イー
й	キリル イークラトコエ
к	キリル カー
л	キリル エル
м	キリル エム
н	キリル エヌ
о	キリル オー
п	キリル ペー
р	キリル エル
с	キリル エス
т	キリル テー
у	キリル ウー
ф	キリル エフ
х	キリル ハー
ц	キリル ツェー
ч	キリル チェー
ш	キリル シャー
щ	キリル シシャー
ъ	キリル コウオンキゴウ
ы	キリル ウィ
ь	キリル ナンオンキゴウ
э	キリル エー
ю	キリル ユー
я	キリル ヤー
ё	キリル ィヨー
‐	ハイフン
―	バー
‘	シングル
’	トジシングル
“	クォーテーション
”	トジクォーテーション
†	ダガー
‡	ダブルダガー
‥	テンテン
…	テンテンテン
‰	パーミル
′	フン
″	ビョウ
※	コメジルシ
℃	ドシー
№	ナンバー
℡	テレフォン
Å	オングストローム
Ⅰ	ローマスウジ イチ
Ⅱ	ローマスウジ ニ
Ⅲ	ローマスウジ サン
Ⅳ	ローマスウジ ヨン
Ⅴ	ローマスウジ ゴ
Ⅵ	ローマスウジ ロク
Ⅶ	ローマスウジ ナナ
Ⅷ	ローマスウジ ハチ
Ⅸ	ローマスウジ キュウ
Ⅹ	ローマスウジ ジュウ
←	ヒダリヤジルシ
↑	ウエヤジルシ
→	ミギヤジルシ
↓	シタヤジルシ
⇒	ナラバ
⇔	ドウチ
∀	フツウゲンテイシ
∂	ラウンドディー
∃	ソンザイゲンテイシ
∇	ナブラ
∈	ゾクスル
∋	ゲントシテフクム
∑	シグマ
√	ルート
∝	ヒレイ
∞	ムゲンダイ
∟	チョッカク
∠	カク
∥	タテヘイコウ
∧	オヨビ
∨	マタハ
∩	キャップ
∪	カップ
∫	インテグラル
∬	ダブルインテグラル
∮	シュウカイセキブン
∴	ユエニ
∵	ナゼナラバ
∽	ソウジ
≒	二アリーイコール
≠	ノットイコール
≡	ゴウドウ
≦	ショウナリイコール
≧	ダイナリイコール
≪	ヒジョウニチイサイ
≫	ヒジョウニオオキイ
⊂	シンブブンシュウゴウ
⊃	シンブブンシュウゴウギャク
⊆	ブブンシュウゴウ
⊇	ブブンシュウゴウギャク
⊥	スイチョク
⊿	サンカクケイ
⌒	コキゴウ
①	マルイチ
②	マルニ
③	マルサン
④	マルヨン
⑤	マルゴ
⑥	マルロク
⑦	マルナナ
⑧	マルハチ
⑨	マルキュウ
⑩	マルジュウ
⑪	マルジュウイチ
⑫	マルジュウニ
⑬	マルジュウサン
⑭	マルジュウヨン
⑮	マルジュウゴ
⑯	マルジュウロク
⑰	マルジュウナナ
⑱	マルジュウハチ
⑲	マルジュウキュウ
⑳	マルニジュウ
─	ヨコセン
━	フトヨコセン
│	タテセン
┃	フトタテセン
┌	ヒダリウエ
┏	フトヒダリウエ
┐	ミギウエ
┓	フトミギウエ
└	ヒダリシタ
┗	フトヒダリシタ
┘	ミギシタ
┛	フトミギシタ
├	タテセンミギ
┝	タテセンフトミギ
┠	フトタテセンホソミギ
┣	フトタテセンミギ
┤	タテセンヒダリ
┥	タテセンフトヒダリ
┨	フトタテセンホソヒダリ
┫	フトタテセンヒダリ
┬	ヨコセンシタ
┯	フトヨコセンホソシタ
┰	ヨコセンフトシタ
┳	フトヨコセンシタ
┴	ヨコセンウエ
┷	フトヨコセンホソウエ
┸	ヨコセンフトウエ
┻	フトヨコセンウエ
┼	クロス
┿	フトヨコセンクロス
╂	フトタテセンクロス
╋	フトクロス
■	クロシカク
□	シカク
▲	クロサンカク
△	サンカク
▼	クロギャクサンカク
▽	ギャクサンカク
◆	クロヒシガタ
◇	ヒシガタ
○	マルジルシ
◎	ニジュウマル
●	クロマル
◯	オオキナマル
★	クロボシ
☆	ホシジルシ
♀	メス
♂	オス
♪	オンプ
♭	フラット
♯	シャープ
　	スペース
、	テン
。	マル
〃	オナジク
々	オドリジ
〆	シメ
〇	ゼロ
〈	ヤマカッコ
〉	トジヤマカッコ
《	ニジュウヤマカッコ
》	トジニジュウヤマカッコ
「	カギ
」	トジカギ
『	ニジュウカギ
』	トジニジュウカギ
【	クロカッコ
】	トジクロカッコ
〒	ユウビン
〓	ゲタジルシ
〔	キッコウ
〕	トジキッコウ
〝	ヒゲヒラキ
〟	ヒゲトジ
ぁ	チイサイ アサヒ ノ ア
あ	アサヒ ノ ア
ぃ	チイサイ イチゴ ノ イ
い	イチゴ ノ イ
ぅ	チイサイ ウサギ ノ ウ
う	ウサギ ノ ウ
ぇ	チイサイ エイゴ ノ エ
え	エイゴ ノ エ
ぉ	チイサイ オオサカ ノ オ
お	オオサカ ノ オ
か	カゾク ノ カ
が	ガッコウ ノ ガ
き	キッテ ノ キ
ぎ	ギンコウ ノ ギ
く	クスリ ノ ク
ぐ	グランド ノ グ
け	ケシキ ノ ケ
げ	ゲーム ノ ゲ
こ	コドモ ノ コ
ご	ゴリラ ノ ゴ
さ	サクラ ノ サ
ざ	ザブトン ノ ザ
し	シンブン ノ シ
じ	ジカン ノ ジ
す	スズメ ノ ス
ず	ズボン ノ ズ
せ	セカイ ノ セ
ぜ	ゼンブ ノ ゼ
そ	ソロバン ノ ソ
ぞ	ゾウキン ノ ゾ
た	タバコ ノ タ
だ	ダルマ ノ ダ
ち	チキュウ ノ チ
ぢ	ハナヂ ノ ヂ
っ	チイサイ ツバメ ノ ツ
つ	ツバメ ツ
づ	ツヅミ ノ ヅ
て	テガミ ノ テ
で	デンワ ノ デ
と	トウキョウ ノ ト
ど	ドレミ ノ ド
な	ナマエ ノ ナ
に	ニホン ノ ニ
ぬ	ヌリエ ノ ヌ
ね	ネズミ ノ ネ
の	ノハラ ノ ノ
は	ハガキ ノ ハ
ば	バナナ ノ バ
ぱ	パジャマ ノ パ
ひ	ヒカリ ノ ヒ
び	ビール ノ ビ
ぴ	ピアノ ノ ピ
ふ	フトン ノ フ
ぶ	ブランコ ノ ブ
ぷ	プリント ノ プ
へ	ヘイワ ノ ヘ
べ	ベルト ノ ベ
ぺ	ペット ノ ペ
ほ	ホケン ノ ホ
ぼ	ボタン ノ ボ
ぽ	ポスト ノ ポ
ま	マッチ ノ マ
み	ミカン ノ ミ
む	ムシ ノ ム
め	メガネ ノ メ
も	モミジ ノ モ
ゃ	チイサイ ヤカン ノ ヤ
や	ヤカン ノ ヤ
ゅ	チイサイ ユカタ ノ ユ
ゆ	ユカタ ノ ユ
ょ	チイサイ ヨット ノ ヨ
よ	ヨット ノ ヨ
ら	ラジオ ノ ラ
り	リンゴ ノ リ
る	ルスバン ノ ル
れ	レモン ノ レ
ろ	ロウカ ノ ロ
ゎ	チイサイ ワカメ ノ ワ
わ	ワカメ ノ ワ
ゐ	ムカシ ノ イ
ゑ	ムカシ ノ エ
を	ヲワリ ノ オ
ん	オシマイ ノ ン
゛	ダクテン
゜	ハンダクテン
ゝ	クリカエシ
ゞ	クリカエシダクテン
ァ	チイサイ アサヒ ノ ア
ア	アサヒ ノ ア
ィ	チイサイ イチゴ ノ イ
イ	イチゴ ノ イ
ゥ	チイサイ ウサギ ノ ウ
ウ	ウサギ ノ ウ
ェ	チイサイ エイゴ ノ エ
エ	エイゴ ノ エ
ォ	チイサイ オオサカ ノ オ
オ	オオサカ ノ オ
カ	カゾク ノ カ
ガ	ガッコウ ノ ガ
キ	キッテ ノ キ
ギ	ギンコウ ノ ギ
ク	クスリ ノ ク
グ	グランド ノ グ
ケ	ケシキ ノ ケ
ゲ	ゲーム ノ ゲ
コ	コドモ ノ コ
ゴ	ゴリラ ノ ゴ
サ	サクラ ノ サ
ザ	ザブトン ノ ザ
シ	シンブン ノ シ
ジ	ジカン ノ ジ
ス	スズメ ノ ス
ズ	ズボン ノ ズ
セ	セカイ ノ セ
ゼ	ゼンブ ノ ゼ
ソ	ソロバン ノ ソ
ゾ	ゾウキン ノ ゾ
タ	タバコ ノ タ
ダ	ダルマ ノ ダ
チ	チキュウ ノ チ
ヂ	ハナヂ ノ ヂ
ッ	チイサイ ツバメ ノ ツ
ツ	ツバメ ノ ツ
ヅ	ツヅミ ノ ヅ
テ	テガミ ノ テ
デ	デンワ ノ デ
ト	トウキョウ ノ ト
ド	ドレミ ノ ド
ナ	ナマエ ノ ナ
ニ	ニホン ノ ニ
ヌ	ヌリエ ノ ヌ
ネ	ネズミ ノ ネ
ノ	ノハラ ノ ノ
ハ	ハガキ ノ ハ
バ	バナナ ノ バ
パ	パジャマ ノ パ
ヒ	ヒカリ ノ ヒ
ビ	ビール ノ ビ
ピ	ピアノ ノ ピ
フ	フトン ノ フ
ブ	ブランコ ノ ブ
プ	プリント ノ プ
ヘ	ヘイワ ノ ヘ
ベ	ベルト ノ ベ
ペ	ペット ノ ペ
ホ	ホケン ノ ホ
ボ	ボタン ノ ボ
ポ	ポスト ノ ポ
マ	マッチ ノ マ
ミ	ミカン ノ ミ
ム	ムシ ノ ム
メ	メガネ ノ メ
モ	モミジ ノ モ
ャ	チイサイ ヤカン ノ ヤ
ヤ	ヤカン ノ ヤ
ュ	チイサイ ユカタ ノ ユ
ユ	ユカタ ノ ユ
ョ	チイサイ ヨット ノ ヨ
ヨ	ヨット ノ ヨ
ラ	ラジオ ノ ラ
リ	リンゴ ノ リ
ル	ルスバン ノ ル
レ	レモン ノ レ
ロ	ロウカ ノ ロ
ヮ	チイサイ ワカメ ノ ワ
ワ	ワカメ ノ ワ
ヰ	ムカシ ノ イ
ヱ	ムカシ ノ エ
ヲ	ヲワリ ノ オ
ン	オシマイ ノ ン
ヴ	ウサギ ノ ウニ ダクテン
ヵ	チイサイ カゾク ノ カ
ヶ	チイサイ ケシキ ノ ケ
・	ナカテン
ー	チョウオン
ヽ	クリカエシ
ヾ	クリカエシダクテン
㈱	カッコカブ
㈲	カッコユウゲン
㈹	カッコダイヒョウ
㊤	マルウエ
㊥	マルナカ
㊦	マルシタ
㊧	マルヒダリ
㊨	マルミギ
㌃	カナアール
㌍	カナカロリー
㌔	カナキリ
㌘	カナグラム
㌢	カナセンチ
㌣	カナセント
㌦	カナドル
㌧	カナトン
㌫	カナパーセント
㌶	カナヘクタール
㌻	カナページ
㍉	カナミリ
㍊	カナミリバール
㍍	カナメートル
㍑	カナリットル
㍗	カナワット
㍻	ヘイセイ
㍼	ショウワ
㍽	タイショウ
㍾	メイジ
㎎	ミリグラム
㎏	キログラム
㎜	ミリメートル
㎝	センチメートル
㎞	キロメートル
㎡	ヘイホウメートル
㏄	シーシー
㏍	ケーケー
一	カンスウジ ノ イチ
丁	イッチョウメ ノ チョウ
七	カンスウジ ノ ナナ
万	マンネンヒツ ノ マン
丈	ダイジョウブ ノ ジョウ，タケ
三	カンスウジ ノ サン
上	ジョウゲ ノ ジョウ，ウエ
下	ジョウゲ ノ ゲ，シタ
不	フシギ ノ フ
与	アタエル，キュウヨ ノ ヨ
丐	カイ，コウ，アタエルノイミ
丑	ウシ，ジュウニシ ノ ウシ
且	ナオカツ ノ カツ
丕	ヒ，フシギノフノシタニカンスウジノイチ
世	セカイ ノ セ，ヨ
丗	セカイノセノキュウジ
丘	サキュウ ノ キュウ，オカ
丙	コウオツヘイ ノ ヘイ
丞	ダイジンヲ イミスル ジョウショウ ノ ジョウ
両	リョウテ ノ リョウ
並	ナミキ ノ ナミ，ナラブ
个	カ，モノノタンイ，ヤネノシタニタテボウ
中	チュウガク ノ チュウ，ナカ
丱	カン，アゲマキ
串	クシカツノ クシ
丶	チュウ，ブンノクギリフゴウ，カタチハテン
丸	ヒノマル ノ マル，ガン
丹	タンネンナ ノ タン
主	シュジンコウ ノ シュ，ヌシ
丼	ドンブリ
丿	ヘツ，カタカナノノノカタチ
乂	ガイ，クサカリノカリノヒダリガワ
乃	ノギタイショウ ノ ノ，スナワチ
久	エイキュウ ノ キュウ，ヒサシイ
之	コレ，アクタガワリュウノスケ ノ ノ
乍	ムカシナガラ ノ ナガラ
乎	コ，ヨブ ノ ツクリ
乏	ビンボウ ノ ボウ，トボシイ
乕	ドウブツノトラノイタイジ
乖	カイリスルノカイ，ソムクノイミ
乗	ジョウシャスル ノ ジョウ，ノル
乘	ジョウシャスルノジョウ，ノルノキュウジ
乙	コウオツ ノ オツ
九	カンスウジ ノ キュウ
乞	コウ，アマゴイスル ノ コウ
也	クウヤネンブツ ノ ヤ，ナリ
乢	カイ，ヤマヘンニレイギノレイノツクリ
乱	コンラン ノ ラン，ミダレル
乳	ギュウニュウ ノ ニュウ，チチ
乾	カワク，カンソウキ ノ カン
亀	ドウブツ ノ カメ，キ
亂	コンランスルノラン，ミダレル
亅	ケツ，カンジノブシュノハネボウ
了	リョウショウスル ノ リョウ
予	ヨテイ ノ ヨ
争	キョウソウ ノ ソウ，アラソウ
亊	ジケンノジ，コトノイタイジ
事	ジケン ノ ジ，コト
二	カンスウジ ノ ニ
于	ウ，ウチュウノウノウカンムリヲトッタモノ
云	ウンヌン ノ ウン，イウ
互	ゴカク ノ ゴ，タガイ
五	カンスウジ ノ ゴ
井	イドミズ ノ イ
亘	ジンメイ ノ ワタル，カキネ ノ カキ ノ ツクリ
亙	ジンメイヨウワタル ノ キョヨウジタイ
些	ササイ ノ サ，イササカ
亜	アネッタイ ノ ア
亞	アネッタイノアノキュウジ
亟	キ，ホッキョクノキョクノツクリ
亠	トウ，ブシュノナベブタ
亡	ボウメイスル ノ ボウ
亢	コウ，テイコウスルノコウノツクリ
交	コウツウ ノ コウ，マジワル
亥	イ，ジュウニシ ノ イノシシ
亦	セツゾクシ ノ マタ，ヘンカスル ノ ヘン ノ ウエガワ
亨	キョウ，ナベブタニ クチニ リョウ
享	キョウラクテキ ノ キョウ
京	トウキョウ ノ キョウ
亭	テイシュ ノ テイ
亮	ジンメイ ノ リョウ，ショカツリョウ ノ リョウ
亰	トウキョウノキョウノイタイジ
亳	ハク，コダイチュウゴクノインノミヤコノヒトツ
亶	タン，ブツダンノダンノツクリ
人	ヒト，ニンゲン ノ ニン
什	ジュウキ ノ ジュウ，ニンベン ニ カンスウジ ノ ジュウ
仁	ジンギ ノ ジン，ニオウ ノ ニ
仂	ロク，ニンベンニチカラ
仄	ソクブンスルノソク，ホノカ
仆	ボク，ニンベンニウラナウノボク
仇	アダ，キュウテキ ノ キュウ
今	コンゲツ ノ コン，イマ
介	カイゴ ノ カイ，スケ
仍	ジョウ，ニンベンニノギタイショウノノ
从	シタガウノイタイジ，ヒトフタツ
仏	ブツゾウ ノ ブツ，ホトケ
仔	シサイナ ノ シ，ニンベン ニ コドモ ノ コ
仕	シゴト ノ シ，ツカエル
他	タニン ノ タ
仗	ギジョウヘイノジョウ
付	フロク ノ フ，ツケル
仙	センニン ノ セン，ニンベン ニ ヤマ
仝	ドウジョウ
仞	フカサノタンイノジン，ニンベンニカタナニテン
仟	セン，ニンベンニカンスウジノセン
代	ダイヒョウ ノ ダイ，カワル
令	メイレイ ノ レイ
以	イジョウ，イカ ノ イ
仭	フカサノタンイノジンノイタイジ，ニンベンニヤイバノイタイジ
仮	カメン ノ カ，カリ
仰	ギョウテンスル ノ ギョウ，アオグ
仲	ナカマ ノ ナカ
件	ジョウケン ノ ケン
价	カイ，ニンベンニチュウカイスルノカイ
任	セキニン ノ ニン
企	キカク ノ キ，クワダテル
伉	コウ，ニンベンニテイコウスルノコウノツクリ
伊	イセエビ ノ イ
伍	ラクゴスル ノ ゴ，ニンベン ニ カンスウジ ノ ゴ
伎	カブキ ノ キ
伏	キフクニトム ノ フク，フセル
伐	バッサイスル ノ バツ
休	ヤスム，キュウジツ ノ キュウ
会	カイシャ ノ カイ，アウ
伜	セガレノイタイジ，ニンベンニカンスウジノキュウトジュウ
伝	デンセツ ノ デン，ツタエル
伯	ハクシャク ノ ハク
估	コ，ニンベンニチュウコシャノコ
伴	ドウハンスル ノ ハン，トモナウ
伶	レイジン ノ レイ，ニンベン ニ メイレイ ノ レイ
伸	シンシュク ノ シン，ノビル
伺	シンタイウカガイ ノ ウカガイ
似	ルイジ ノ ジ，ニル
伽	オトギバナシ ノ トギ，カ
佃	ツクダニ ノ ツクダ
但	タダシガキ ノ タダシ
佇	チョリツスルノチョ，タタズム
位	タンイ ノ イ
低	ヒクイ，テイ
住	ジュウショ ノ ジュウ，スム
佐	ホサスル ノ サ
佑	テンユウ ノ ユウ，ニンベン ニ ミギ
体	カラダ，タイイク ノ タイ
何	ナニモノ ノ ナニ
佗	タ，ワビ，ニンベンニウカンムリニカタカナノヒ
余	ヨユウ ノ ヨ，アマル
佚	アンイツノイツ，ニンベンニウシナウ
佛	ブツゾウノブツノキュウジ
作	サクブン ノ サク，ツクル
佝	ク，ニンベンニハイクノク
佞	カンネイノネイ
佩	ハイヨウスルノハイ，オビル
佯	ヨウ，ニンベンニドウブツノヒツジ
佰	ハク，ニンベンニカンスウジノヒャク
佳	カサク ノ カ，ニンベン ニ ツチ フタツ ノ カ
併	ヘイヨウスル ノ ヘイ，アワセル
佶	キツ，ニンベンニダイキチノキチ
佻	ケイチョウフハクノチョウ
佼	ニンベン ニ マジワル ノ コウ
使	シヨウスル ノ シ，ツカウ
侃	カンカンガクガク ノ カン
來	ライネンノライ，クルノキュウジ
侈	シャシニナガレルノシ，ニンベンニオオイスクナイノオオイ
例	レイダイ ノ レイ，タトエル
侍	ジジュウ ノ ジ，サムライ
侏	シュジュノシュ，ニンベンニシュイロノシュ
侑	ユウ，ニンベンニユウメイジンノユウ
侖	リン，シャリンノリンノツクリ
侘	タ，ワビシイノワビ，ニンベンニジュウタクノタク
供	テイキョウスル ノ キョウ，ソナエル
依	イライスル ノ イ
侠	ニンキョウ ノ キョウ
価	カチ ノ カ，アタイ
侫	カンネイノネイノイタイジ
侭	ワガママ ノ ママ，ニンベン ニ ツクス
侮	ブジョクスル ノ ブ，アナドル
侯	オウコウキゾク ノ コウ
侵	シンリャク ノ シン，オカス
侶	ソウリョ ノ リョ
便	ユウビン ノ ビン，タヨリ
係	カンケイ ノ ケイ，カカリ
促	サイソクスル ノ ソク，ウナガス
俄	ニワカ，ガゼン ノ ガ
俊	シュンビンサ ノ シュン
俎	マナイタ，ソジョウノソ
俐	レイリノリ，ニンベンニケンリノリ
俑	ヘイバヨウノヨウ
俔	ケン，ニンベンニケンブツスルノケン
俗	フウゾク ノ ゾク
俘	トリコ，フリョノフ
俚	リゲンノリ，ニンベンニサトガエリノサト
俛	ベン，ニンベンニメンキョノメン
保	ホケンシツ ノ ホ，タモツ
俟	シ，マツ，ニンベンニカタカナノムノシタニユミヤノヤ
信	シンゴウキ ノ シン
俣	ミナマタビョウ ノ マタ
俤	オモカゲ，ニンベンニオトウト
俥	クルマ，ニンベンニデンシャノシャ
修	シュウリスル ノ シュウ
俯	ウツムク，フカンスルノフ
俳	ハイク ノ ハイ
俵	ドヒョウ ノ ヒョウ，タワラ
俶	シュク，ニンベンニシュクジョノシュクノツクリ
俸	ホウキュウ ノ ホウ
俺	オレサマ ノ オレ
俾	ヘイ，ニンベンニヒクツナノヒ
倅	セガレ，ニンベンニソツギョウノソツ
倆	リョウ，ニンベンニリョウテノリョウノキュウジ
倉	ソウコ ノ ソウ，クラ
個	コセイテキ ノ コ
倍	バイリツ ノ バイ
倏	シュク，ジョウケンノジョウノキュウジノキノカワリニドウブツノイヌ
們	モン，ニンベンニセンモンノモン
倒	トウサンスル ノ トウ，タオレル
倔	クツ，ニンベンニリクツノクツ
倖	ギョウコウ ノ コウ，ニンベン ニ サチ
候	リッコウホ ノ コウ
倚	イ，ニンベンニキミョウナノキ
借	シャクヨウ ノ シャクカリル
倡	ショウ，ニンベンニガッショウキョクノショウノツクリ
倣	モホウスル ノ ホウ，ナラウ
値	ネダン ノ ネ，アタイ
倥	コウ，ニンベンニクウキノクウ
倦	ケンタイカン ノ ケン，ウム
倨	キョゴウノキョ，ニンベンニジュウキョノキョ
倩	セン，ニンベンニアオノキュウジタイ
倪	タンゲイノゲイ，ニンベンニヌラムノツクリ
倫	リンリテキナ ノ リン
倬	タク，ニンベンニタッキュウノタク
倭	ギシワジンデン ノ ワ
倶	クラブ ノ ク
倹	ケンヤクスル ノ ケン
偃	エン，ニンベンニエンテイノエン，セキノツクリ
假	カメンノカ，カリノキュウジ
偈	ゲ，ニンベンニカッショクノカツノツクリ
偉	イダイ ノ イ，エライ
偏	ヘンセイフウ ノ ヘン，カタヨル
偐	ガン，ニンベンニヒコボシノヒコノキュウジ
偕	カイ，トモニ，ニンベンニミナサマノミナ
偖	シャ，ニンベンニカガクシャノシャノキュウジタイ
做	サ，ニンベンニコキョウノコ
停	テイシャ ノ テイ
健	ケンコウ ノ ケン，スコヤカ
偬	ソウ，ニンベンニネギノクサカンムリヲトッタモノ
偲	コジンヲ シノブ ノ シノブ
側	リョウガワ ノ ガワ，ソク
偵	テイサツスル ノ テイ
偶	グウゼン ノ グウ
偸	トウ，ニンベンニユカイナノユノツクリ
偽	ギゾウ ノ ギ，ニセ
傀	カイライセイケンノカイ
傅	フイクスルノフ，メノト
傍	ボウカンシャ ノ ボウ，カタワラ
傑	ゴウケツ ノ ケツ
傘	ラッカサン ノ サン，カサ
備	ジュンビスル ノ ビ，ソナエル
傚	コウ，ニンベンニコウカテキノコウノキュウジ
催	モヨオス，カイサイ ノ サイ
傭	ヨウヘイ ノ ヨウ，ヤトウ
傲	ゴウマンナノゴウ
傳	デンセツノデンノキュウジ
傴	ウ，ニンベンニクベツスルノクノキュウジ
債	サイムヲオウ ノ サイ
傷	キズ，ジュウショウ ノ ショウ
傾	カタムク，ケイコウ ノ ケイ
僂	ロウ，ニンベンニロウカクノロウノキュウジノツクリ
僅	ワズカ，キンサ ノ キン
僉	シケンヲウケルノケンノキュウジノツクリ
僊	セン，ニンベンニサセンスルノセンノツクリ
働	ロウドウ ノ ドウ，ハタラク
像	ブツゾウ ノ ゾウ
僑	チュウゴク ノ カキョウ ノ キョウ
僕	シモベ，コウボク ノ ボク
僖	キ，ニンベンニキゲキノキ，ヨロコブ
僚	カイシャ ノ ドウリョウ ノ リョウ
僞	ギゾウノギ，ニセノキュウジ
僣	センエツナガラノセンノイタイジ
僥	ギョウコウノギョウ，ニンベンニギョウシュンギョウノキュウジ
僧	ソウリョ ノ ソウ
僭	センエツナガラノセン
僮	ドウ，ニンベンニワラベ
僵	キョウ，ニンベンニカシハラジングウノカシノツクリ
價	カチノカ，アタイノキュウジ
僻	ヘキチ ノ ヘキ
儀	ギシキ ノ ギ
儁	シュン，ニンベンニフルトリニユミ
儂	ノウ，ニンベンニノウギョウノノウ
億	オクマンチョウジャ ノ オク
儉	ケンヤクスルノケンノキュウジ
儒	ジュガク ノ ジュ
儔	チュウ，ニンベンニコトブキノキュウジ
儕	セイ，ニンベンニイッセイシャゲキノセイノキュウジ
儖	ラン，ニンベンニカントクスルノカン
儘	ワガママノママ，ジン
儚	ボウ，ニンベンニユメ，ハカナイ
償	バイショウキン ノ ショウ，ツグナウ
儡	カイライセイケンノライ
優	ユウショウスル ノ ユウ，ヤサシイ
儲	モウカル，ニンベン ニ ショクン ノ ショ
儷	レイ，ニンベンニウルワシイ
儺	ダ，ニンベンニコンナンノナン
儻	トウ，ニンベンニヨトウヤトウノトウノキュウジ
儼	ゲン，ニンベンニゲンジュウナノゲン
儿	ジン，ブシュノヒトアシ
兀	ゴツ，カンスウジノイチノシタニヒトアシ
允	インカ ノ イン，ユルス
元	ゲンキ ノ ゲン，モト
兄	アニ オトウト ノ アニ
充	ジュウジツ ノ ジュウ
兆	イッチョウエン ノ チョウ
兇	キョウダンニタオレル ノ キョウ，ヒトアシ ノ キョウ
先	センセイ ノ セン，サキ
光	ヒカリ，ニッコウ ノ コウ
克	コクフクスル ノ コク，カツ
兌	ダカンシヘイノダ
免	メンキョ ノ メン
兎	ウサギ
児	ジドウセイト ノ ジ
兒	ジドウセイトノジノキュウジ
兔	ドウブツノウサギノイタイジ
党	ヨトウヤトウ ノ トウ
兜	テツカブト ノ カブト
兢	センセンキョウキョウノキョウ，コクフクスルノコクフタツ
入	ハイル，ニュウガク ノ ニュウ
全	ゼンコク ノ ゼン，マッタク
兩	リョウテノリョウノキュウジ
兪	ユ，ニレノキノニレノツクリ
八	カンスウジ ノ ハチ
公	シュジンコウ ノ コウ，オオヤケ
六	カンスウジ ノ ロク
兮	ケイ，カンスウジノハチノシタニゴウキュウスルノゴウノシタガワ
共	キョウツウ ノ キョウ，トモ
兵	ヘイタイ ノ ヘイ
其	ソノタ ノ ソ
具	ドウグ ノ グ
典	コクゴジテン ノ テン
兼	カネル，ケンギョウ ノ ケン
冀	キ，キタノシタニコトナル
冂	ケイ，ブシュノドウガマエ
内	コクナイ ノ ナイ，ウチ
円	ヒャクエンダマ ノ エン
冉	ゼン，フタタビカライッカクメヲトッタカタチ
冊	イッサツニサツ ノ サツ
册	イッサツニサツノサツノキュウジ
再	フタタビ，サイ
冏	ケイ，ドウガマエニカタカナノルトロ
冐	ボウケンカノボウノイタイジ
冑	カッチュウノチュウ，カブト
冒	ボウケンカ ノ ボウ
冓	コウ，ミゾノツクリ
冕	ベン，カンムリ
冖	ベキ，ブシュノワカンムリ
冗	ジョウダンヲイウ ノ ジョウ
写	シャシン ノ シャ，ウツス
冠	カンムリ，エイカン ノ カン
冢	チョウ，カイヅカノツカノモトノジ
冤	エンザイヲハラスノエン
冥	メイフクヲ イノル ノ メイ
冦	モウコシュウライノゲンコウノコウノイタイジ
冨	フジサン ノ フ ノ イタイジ，ワカンムリ
冩	シャシンノシャ，ウツスノキュウジノイタイジ，ワカンムリ
冪	ベキ，ワカンムリニジマクノマク
冫	ヒョウ，ブシュノニスイ
冬	フユヤスミ ノ フユ，トウ
冰	ヒョウガノヒョウ，コオリノイタイジ，ニスイ
冱	コ，ニスイニゴカクノゴ
冲	チュウ，ニスイニチュウガッコウノチュウ
决	タスウケツノケツ，キメルノイタイジ，ニスイ
冴	メガサエル ノ サエル
况	ジッキョウチュウケイノキョウノイタイジ，ニスイ
冶	ヤキンガク ノ ヤ
冷	レイトウ ノ レイ，ツメタイ
冽	リンレツノレツ，ニスイニギョウレツノレツ
凄	セイサンナ ノ セイ，スゴイ
凅	コ，コオル，ニスイニカタマル
准	ヒジュンスル ノ ジュン
凉	スズシイノイタイジ，ニスイ
凋	チョウラク ノ チョウ，シボム
凌	リョウガスル ノ リョウ，シ ノ グ
凍	レイトウスル ノ トウ，コオル
凖	ジュンビスルノジュンノイタイジ
凛	リンレツタルノリンノイタイジ
凜	リンレツタルノリン
凝	コル，ギョウコスル ノ ギョウ
几	キチョウメンノキ，ツクエ
凡	ヘイボン ノ ボン
処	ショブン ノ ショ
凧	タコアゲ ノ タコ
凩	コガラシ
凪	ユウナギ ノ ナギ
凭	ヒョウ，モタレル
凰	トリノホウオウノオウ
凱	ガイセンモン ノ ガイ
凵	ケン，ブシュノウケバコ
凶	キチトキョウ ノ キョウ
凸	オウトツ ノ トツ
凹	オウトツ ノ オウ，クボム
出	デル，ガイシュツ ノ シュツ
函	ハコダテ ノ ハコ，カン
凾	ハコダテノハコ，カンノイタイジ
刀	カタナ，ニホントウ ノ トウ
刃	ハモノ ノ ハ，ヤイバ
刄	ハモノノハ，ヤイバノイタイジ
分	ハンブン ノ ブン，ワケル
切	タイセツ ノ セツ，キル
刈	クサカリ ノ カリ，カル
刊	シュウカンシ ノ カン
刋	セン，カタカナノチノミギニリットウ
刎	フンケイノマジワリノフン
刑	ケイムショ ノ ケイ
刔	ケツ，エグル，タスウケツノケツノツクリノミギニリットウ
列	ギョウレツ ノ レツ
初	サイショ ノ ショ，ハジメテ
判	ハンダン ノ ハン
別	トクベツ ノ ベツ，ワカレル
刧	ミライエイゴウノゴウノイタイジ
利	ケンリ ノ リ
刪	サン，ケズル，イッサツニサツノサツノミギニリットウ
刮	カツモクスルノカツ
到	トウチャクスル ノ トウ，イタル
刳	クリヌクノクル，コ
制	セイゲンスル ノ セイ
刷	インサツ ノ サツ，スル
券	ジョウシャケン ノ ケン
刹	セツナテキナノナ
刺	シゲキスル ノ シ，サス
刻	ジコク ノ コク，キザム
剃	ソル，テイハツ ノ テイ
剄	ケイドウミャクノケイノヒダリガワニリットウ
則	ホウソク ノ ソク
削	サクゲンスル ノ サク，ケズル
剋	ゲコクジョウノコク，コクフクスルノコクニリットウ
剌	ハツラツノラツ
前	マエ，ゼンゴ ノ ゼン
剏	ソウ，ヘイヨウスルノヘイノツクリニヤイバノイタイジ
剔	テキシュツスルノテキ，ボウエキノエキ，ヤサシイニリットウ
剖	カイボウスル ノ ボウ
剛	シツジツゴウケン ノ ゴウ
剞	キ，キミョウナノキニリットウ
剣	ケンドウ ノ ケン，ツルギ
剤	ヤクザイシ ノ ザイ
剥	ハクリスル ノ ハク，ハガレル
剩	ジョウ，ジシンカジョウノジョウノキュウジ
剪	ニワキヲセンテイスルノセン，キル
副	フクカイチョウ ノ フク
剰	ジシンカジョウ ノ ジョウ
剱	ケン，ツルギノイタイジ，ジョウヨウカンジノケンノツクリガヤイバノイタイジ
割	ワリアイ ノ ワリ
剳	ゴジュウノトウノトウノツクリニリットウ
剴	ガイ，ヨロイノツクリニリットウ
創	ソウリツスル ノ ソウ
剽	ヒョウセツスルノヒョウ
剿	ハチノスノスニリットウ
劃	ワカツ，カクゼン ノ カク
劇	ニンギョウゲキ ノ ゲキ
劈	ヘキ，カベノツチノカワリニカタナ
劉	リュウホウ ノ リュウ
劍	ケン，ツルギノキュウジ
劑	ヤクザイシノザイノキュウジ
劒	ケン，ツルギノイタイジ，ツクリガカタナニテン
劔	ケン，ツルギノイタイジ，ツクリガヤイバノイタイジ
力	チカラ，タイリョク ノ リョク
功	フセイコウ ノ コウ
加	ツイカ ノ カ，クワエル
劣	オトル，ユウレツ ノ レツ
助	キュウジョ ノ ジョ，タスケル
努	ドリョク ノ ド
劫	ミライエイゴウ ノ ゴウ
劬	ク，ハイクノクニチカラ
劭	ショウ，マネクノツクリニチカラ
励	ゲキレイスル ノ レイ，ハゲマス
労	ロウドウ ノ ロウ
劵	ケン，ジョウシャケンノケンノカタナノカワリニチカラ
効	コウカテキ ノ コウ
劼	カツ，ダイキチノキチニチカラ
劾	ダンガイスル ノ ガイ
勁	ケイ，ツヨイ，ケイドウミャクノケイノヒダリガワニチカラ
勃	ボッパツスル ノ ボツ
勅	チョクメイ ノ チョク
勇	ユウキ ノ ユウ，イサマシイ
勉	ベンキョウ ノ ベン
勍	ケイ，トウキョウノキョウニチカラ
勒	ミロクボサツノロク
動	ドウブツ ノ ドウ，ウゴク
勗	キョク，ニチョウビノニチノシタニキュウジョスルノジョ
勘	オカンジョウ ノ カン
務	ギム ノ ム，ツトメル
勝	カチマケ ノ カチ，ショウ
勞	ロウドウノロウノキュウジ
募	ボシュウスル ノ ボ，ツノル
勠	リク，ゴビュウノビュウノツクリニチカラ
勢	セイリョク ノ セイ，イキオイ
勣	セキ，セキニンノセキニチカラ
勤	キンム ノ キン
勦	ソウ，ハチノスノキュウジニチカラ
勧	カンユウスル ノ カン，ススメル
勲	クンショウ ノ クン，イサオ
勳	クンショウノクン，イサオノキュウジ
勵	ゲキレイスルノレイノキュウジ
勸	カンユウスルノカン，ススメルノキュウジ
勹	ホウ，ブシュノツツミガマエ
勺	ヨウセキ ノ タンイ ノ シャク，ツツミガマエ ニ テン
勾	キュウコウバイ ノ コウ
勿	モチロン ノ モチ
匁	オモサ ノ タンイ ノ モンメ
匂	イイニオイ ノ ニオイ
包	ホウタイ ノ ホウ，ツツム
匆	ソウ，ネギカラクサカンムリトココロヲトッタカタチ
匈	ユウボクミンゾクノキョウドノキョウ
匍	ホフクゼンシンノホ
匏	ホウ，ヒサゴ，ハカマノツクリニ，ヒョウガフルノヒョウノシタガワ
匐	ホフクゼンシンノフク
匕	サジヲイミスルヒ
化	カセキ ノ カ，バケル
北	キタミナミ ノ キタ，ホク
匙	サジカゲン ノ サジ
匚	ホウ，ブシュノハコガマエ
匝	ソウ，ハコガマエ ニ ハバ
匠	キョショウ ノ ショウ，タクミ
匡	タダス，キョウ，ハコガマエ ニ オウ
匣	コウ，ハコガマエニコウオツノコウ
匪	ヒゾク ノ ヒ，ハコガマエ ニ ヒジョウグチ ノ ヒ
匯	カイ，ハコガマエニサンズイトフルトリ
匱	キ，ハコガマエニキチョウヒンノキ
匳	ハコガマエニシケンヲウケルノケンノキュウジノツクリ
匸	ケイ，ブシュノカクシガマエ
匹	イッピキニヒキ ノ ヒキ
区	クベツ ノ ク
医	オイシャサン ノ イ
匿	トクメイ ノ トク，カクス
區	クベツスルノクノキュウジ
十	カンスウジ ノ ジュウ
千	カンスウジ ノ セン
卅	ソウ，カンスウジノサンジュウ
卆	ソツギョウノソツノイタイジ
升	イッショウビン ノ ショウ，マス
午	ショウゴ ノ ゴ
卉	カキエンゲイノキ
半	ハンブン ノ ハン，ナカバ
卍	マンジ
卑	ヒレツナ ノ ヒ，イヤシイ
卒	ソツギョウ ノ ソツ
卓	タッキュウ ノ タク
協	キョウリョクスル ノ キョウ
南	ナンボク ノ ナン，ミナミ
単	タンジュン ノ タン
博	ハクブツカン ノ ハク
卜	ウラナウ，ボク
卞	ベン，ナベブタノシタニカタカナノト
占	ドクセンスル ノ セン，シメル
卦	ハッケ ノ ケ
卩	セツ，ブシュノワリフ
卮	シ，サカズキ
卯	ウ，ジュウニシ ノ ウサギ
印	インサツ ノ イン
危	キケン ノ キ，アブナイ
即	ソクザニ ノ ソク，スナワチ
却	ヘンキャクスル ノ キャク
卵	タマゴ
卷	カン，ノリマキノマキノキュウジ
卸	オロシウリ ノ オロシ
卻	ヘンキャクスルノキャクノイタイジ
卿	キョウ，スウキケイ ノ ケイ
厂	カン，ブシュノガンダレ
厄	ヤクドシ ノ ヤク
厖	ボウダイナノボウ，ガンダレニムクイヌ
厘	クブクリン ノ リン
厚	アツガミ ノ アツ
原	ゲンイン ノ ゲン，ハラ
厠	カワヤ，ガンダレニホウソクノソク
厥	ユウボクミンゾクノトッケツノケツ
厦	カ，ガンダレニナツ
厨	チュウボウ ノ チュウ，クリヤ
厩	キュウシャ ノ キュウ，ウマヤ
厭	エンセイカン ノ エン，イトウ
厮	シ，ガンダレニシカイノケンイノシ
厰	カイグンコウショウノショウノイタイジ，ガンダレ
厳	ゲンジュウナ ノ ゲン，キビシイ
厶	シ，ワタクシ，カタカナノム
去	キョネン ノ キョ，サル
参	サンカスル ノ サン，マイル
參	サンカスルノサン，マイルノキュウジ
又	マタガシ ノ マタ
叉	ヤシャ ノ シャ
及	フキュウスル ノ キュウ，オヨブ
友	ユウジン ノ ユウ，トモ
双	ソウガンキョウ ノ ソウ
反	ハンタイスル ノ ハン
収	シュウニュウ ノ シュウ，オサメル
叔	オジオバ ノ シュク
取	シュザイ ノ シュ，トル
受	ジュケン ノ ジュ，ウケル
叙	ジジョデン ノ ジョ
叛	ハンラン ノ ハン，ソムク
叟	サンバソウノソウ，オキナ
叡	ヒエイザン ノ エイ
叢	ソウショ ノ ソウ，クサムラ
口	クチブエ ノ クチ，コウ
古	フルイ，コダイ ノ コ
句	ハイク ノ ク
叨	トウ，クチヘンニカタナ
叩	カタタキ ノ タタク
只	タダイマ ノ タダ
叫	サケブ，ゼッキョウ ノ キョウ
召	ショウシュウスル ノ ショウ，メス
叭	ガッキノラッパノハ
叮	テイ，クチヘンニイッチョウメノチョウ
可	カノウセイ ノ カ
台	ダイドコロ ノ ダイ
叱	シカル，シッセキスル ノ シツ
史	レキシテキ ノ シ
右	ミギ，サユウ ノ ユウ
叶	カナウ，クチヘン ニ ジュウ
号	バンゴウ ノ ゴウ
司	シカイシャ ノ シ
叺	フクロノカマス，クチヘンニハイル
吁	ク，クチヘンニウチュウノウノウカンムリヲトッタモノ
吃	ドモル，キツオン ノ キツ
各	カクジ ノ カク，オノオノ
合	ゴウカク ノ ゴウ，アウ
吉	キチトキョウ ノ キチ，ヨシ
吊	ツルス，クチ ノ シタニ ハバ
吋	ナガサ ノ タンイ ノ インチ
同	オナジ，ドウジ ノ ドウ
名	ナマエ ノ ナ，メイ
后	コウゴウ ノ ゴウ，キサキ
吏	ヤクニンヲ イミスル カンリ ノ リ
吐	トイキ ノ ト，ハク
向	コウジョウスル ノ コウ，ムカウ
君	ショクン ノ クン，キミ
吝	リンショクカノリン
吟	ギンミスル ノ ギン
吠	ホエル，クチヘン ニ イヌ
否	ヒテイスル ノ ヒ
吩	フン，クチヘンニハンブンノブン
含	フクム，ガンチク ノ ガン
听	オモサノタンイノポンド
吭	コウ，クチヘンニテイコウスルノコウノツクリ
吮	セン，クチヘンニカタカナノムノシタニヒトアシ
吶	トツベンノトツ，クチヘンニコクナイノナイ
吸	コキュウスル ノ キュウ，スウ
吹	スイソウガク ノ スイ，フク
吻	セップンスル ノ フン
吼	シシクノク，クチヘンニコウシモウシノコウ
吽	アウンノコキュウノウン，クチヘンニドウブツノウシ
吾	ワレ，ゴ，カンスウジ ノ ゴ ノ シタニ クチ
呀	カ，クチヘンニキバ
呂	オフロ ノ ロ
呆	アキレル，ボウゼントスル ノ ボウ
呈	ゾウテイスル ノ テイ
呉	ゴフクヤ ノ ゴ，クレ
告	コウコク ノ コク，ツゲル
呎	ナガサノタンイノフィート
呑	ヘイドンスル ノ ドン，ノム
呟	ツブヤク
周	シュウヘン ノ シュウ，マワリ
呪	ノロウ，ジュモン ノ ジュ
呰	シ，ヒガンシガンノシノシタニクチ
呱	ココノコエヲアゲルノコ
味	イミ ノ ミ，アジ
呵	タンカヲキルノカ，クチヘンニカノウセイノカ
呶	ド，クチヘンニヤッコ
呷	コウ，サケヲアオルノアオル，クチヘンニコウオツノコウ
呻	シンギンスルノシン，ウメク
呼	コキュウスル ノ コ，ヨブ
命	ウンメイ ノ メイ，イノチ
咀	カミクダクイミノソシャクノソ
咄	トッサノトツ，クチヘンニデル
咆	トラノホウコウノホウ，ホエル
咋	サクネン ノ サク ノ ヒヘン ノ カワリニ クチヘン
和	ワフク ノ ワ
咎	トガメル
咏	エイ，クチヘンニエイキュウノエイ
咐	ホ，クチヘンニフロクノフ，ツケル
咒	ノロウ，ジュモンノジュノイタイジ
咢	ガク，キョウガクスルノガクノツクリ
咤	シッタゲキレイノタ，クチヘンニジュウタクノタク
咥	テツ，クチヘンニゲシノシ
咨	シ，ハカル，ツギノシタニクチ
咫	ナガサノタンイノシ，シャクハチノシャクノミギニタダイマノタダ
咬	カム，コウ，クチヘンニマジワル
咯	ラク，クチヘンニオノオノ
咲	ハナガサク ノ サク
咳	セキバライ ノ セキ
咸	シンノミヤコ，カンヨウノカン
咼	カ，ナベノツクリ
咽	ジビインコウカ ノ イン，ノド
咾	ロウ，クチヘンニロウジンノロウ
哀	キドアイラク ノ アイ，アワレム
品	シナモノ ノ シナ，ヒン
哂	シン，ワラウ，クチヘンニニシヒガシノニシ
哄	コウ，クチヘンニキョウツウノキョウ
哇	アイ，クチヘンニツチフタツ
哈	ゴウ，クチヘンニゴウカクノゴウ
哉	ゼンザイ ノ サイ，カナ
哘	サソウ，クチヘンニリョコウノコウ
員	ガッキュウイイン ノ イン
哢	ロウ，クチヘンニホンロウスルノロウ
哥	ウタ，カ，カノウセイノカヲカサネル
哦	ガ，クチヘンニガマンノガ
哨	ゼンショウセン ノ ショウ
哩	タンイ ノ マイル，クチヘン ニ サト
哭	ドウコクスルノコク，ナク
哮	ホエル，ホウコウスルノコウ
哲	テツガク ノ テツ
哺	ホニュウルイノホ
哽	コウ，クチヘンニサラシナノサラ
唄	ウタ，クチヘン ニ カイガラ ノ カイ
唆	シサスル ノ サ
唇	クチビル，シン
唏	キ，クチヘンニキボウノキ
唐	ケントウシ ノ トウ
唔	ゴ，クチヘンニタゴサクノゴ
唖	アゼントスル ノ ア
售	シュウ，ウル，フルトリノシタニクチ
唯	ユイイツ ノ ユイ
唱	ガッショウ ノ ショウ，トナエル
唳	レイ，クチヘンニモドル
唸	ウナル，クチヘンニザンネンノネン
唹	オ，クチヘンニナニナニニオイテノオ
唾	ダエキ ノ ダ，ツバ
啀	イガミアウノイガム，ガイ
啄	タクボク ノ タク，ツイバム
啅	タク，クチヘンニタッキュウノタク
商	ショウバイ ノ ショウ
啌	コウ，クチヘンニクウキノクウ
問	モンダイ ノ モン，トウ
啓	ケイハツ ノ ケイ
啖	タンカヲキルノタン
啗	タン，クラウ，クチヘンニアンコノアンノツクリ
啜	ススル，セツ
啝	カ，クチヘンニワフクノワ
啣	クツワノイタイジ，クチヘンニオロシウリノオロシ
啻	タダ，テイオウノテイノシタニクチ
啼	テイ，ナク，クチヘンニテイオウノテイ
啾	シュウ，ナク，クチヘンニアキマツリノアキ
喀	カッケツスルノカク，クチヘンニオキャクノキャク
喃	ナン，クチヘンニナンボクノナン
善	ゼンアク ノ ゼン，ヨイ
喇	ガッキノラッパノラツ
喉	ノドボトケ ノ ノド，コウ
喊	カンセイヲアゲルノカン，サケブ
喋	シャベル
喘	ゼンソクノゼン
喙	カイ，クチバシ，タニンゴトニヨウカイスルノカイ
喚	ショウニンカンモン ノ カン
喜	キゲキ ノ キ，ヨロコブ
喝	キョウカツスル ノ カツ
喞	ショク，カコツ，クチヘンニソク
喟	キ，クチヘンニイブクロノイ
喧	ケンカリョウセイバイ ノ ケン
喨	リョウ，クチヘンニジンメイ，ショカツリョウノリョウ
喩	ヒユノユ，タトエル
喪	モチュウ ノ モ
喫	キツエンスル ノ キツ
喬	キョウボク ノ キョウ，タカシ
單	タンジュンナノタンノキュウジ
喰	クチヘン ニ タベル ノ クウ
営	エイギョウ ノ エイ，イトナム
嗄	コエガカレルノカレル，クチヘンニナツ
嗅	キュウカクノキュウ，カグ
嗇	リンショクカノショク
嗔	シン，イカル，クチヘンニマゴコロノマノキュウジ
嗚	オエツノオ，クチヘンニカラス
嗜	シコウヒンノシ，タシナム
嗟	トッサノサ，クチヘンニサベツカスルノサ
嗣	ヨツギ ノ ツギ，セイシ ノ シ
嗤	シ，ワラウ，アザワラウ
嗷	ゴウ，クチヘンニゴウマンノゴウノツクリ
嗹	レン，クチヘンニレンラクノレン
嗽	ソウ，クチススグ，クチヘンニナツメソウセキノソウノツクリ
嗾	ソウ，ソソノカス，クチヘンニスイゾクカンノゾク
嘆	ナゲク，タンガンスル ノ タン
嘉	カ，ヨロコブ ノ シタガ クワエル
嘔	オウトスルノオウ，クチヘンニクベツスルノクノキュウジ
嘖	サク，クチヘンニセキニンノセキ
嘗	ガシンショウタン ノ ショウ，ナメル
嘘	ウソツキ ノ ウソ
嘛	ラマキョウノマ，クチヘンニマスイノマ
嘩	クチゲンカ ノ カ
嘯	ショウ，ウソブク，クチヘンニシシュウノシュウノツクリ
嘱	ショクタクスル ノ ショク
嘲	チョウショウスルノチョウ，アザケル
嘴	クチバシ，シ
嘶	イナナク，セイ
嘸	サゾカシノサゾ，クチヘンニムリノム
噂	ウワサバナシ ノ ウワサ
噌	ミソ ノ ソ
噎	エツ，ムセブ，クチヘンニケイヤクショニツカウイチノキュウジ
噐	ウツワ，ガッキノキノイタイジ
噛	カム，クチヘン ニ ハ
噤	キン，ツグム，クチヘンニキンシスルノキン
器	ガッキ ノ キ，ウツワ
噪	ソウ，クチヘンニソウジュウスルノソウノツクリ
噫	アア，クチヘンニイミノイ
噬	ホゾヲカムノカム，クチヘンニゼイチクノゼイ
噴	フンカスル ノ フン，フク
噸	オモサ ノ タンイ ノ トン
噺	ハナシカ ノ ハナシ，クチヘン ニ アタラシイ
嚀	ネイ，クチヘンニテイネイノネイ
嚆	ハジマリヲイミスルコウシノコウ
嚇	イカクスル ノ カク
嚊	カカアデンカノカカ，クチヘンニハナカゼノハナ
嚏	テイ，クサメノイタイジ
嚔	テイ，クサメ
嚠	リュウ，クチヘンニリュウホウノリュウ
嚢	ヒョウノウ ノ ノウ，フクロ
嚥	エンゲスルノエン
嚮	キョウ，ウマレコキョウノキョウノシタニムカウ
嚴	ゲンジュウナノゲン，キビシイノキュウジ
嚶	オウ，クチヘンニサクラノキュウジノツクリ
嚼	ソシャクスルノシャク，カム
囀	サエズル，クチヘンニウンテンノテンノキュウジ
囁	ササヤク
囂	ケンケンゴウゴウノゴウ
囃	ゴニンバヤシノハヤシ
囈	ゲイ，クチヘンニゲイジュツノゲイノキュウジ
囎	ソ，クチヘンニカイガラノカイニキソジノソノキュウジ
囑	ショク，ショクタクスルノショクノキュウジ
囓	ゲツ，クチヘンニゲッシルイノゲツ
囗	イ，ブシュノクニガマエ
囘	マワル，カイテンノカイノイタイジ，ドウガマエニジュウニシノミ
囚	シュウジン ノ シュウ，トラワレル
四	カンスウジ ノ ヨン
回	マワル，カイテン ノ カイ
因	ゲンイン ノ イン，チナミニ
団	ダンタイコウドウ ノ ダン
囮	オトリソウサノオトリ
困	コンナン ノ コン，コマル
囲	イゴ ノ イ，カコム
図	トショカン ノ ト，ズ
囹	レイ，クニガマエニメイレイスルノレイ
固	コタイ ノ コ，カタイ
国	コクゴ ノ コク，クニ
囿	ユウ，クニガマエニユウメイジンノユウ
圀	クニノイタイジ，トクガワミツクニノクニ
圃	ハタケ ノ イミ ノ ホジョウ ノ ホ
圄	ゴ，クニガマエニタゴサクノゴ
圈	ケン，シュトケンノケンノキュウジ
圉	ギョ，クニガマエニシアワセ
國	クニ，コクゴノコクノキュウジ
圍	カコム，イゴノイノキュウジ
圏	シュトケン ノ ケン
園	ドウブツエン ノ エン
圓	エン，ヒャクエンダマノエンノキュウジ
圖	ズ，トショカンノトノキュウジ
團	ダン，ダンタイコウドウノダンノキュウジ
圜	カン，クニガマエニシゼンカンキョウノカンノツクリ
土	ドヨウビ ノ ド，ツチ
圦	イリ，ツチヘンニニュウガクスルノニュウ
圧	アツリョク ノ アツ
在	ソンザイ ノ ザイ
圭	ツチ フタツ ノ ケイ
地	チキュウ ノ チ
圷	アクツ，ツチヘンニジョウゲノゲ
圸	ママ，ツチヘンニヤマ
圻	キ，ツチヘンニショクパンイッキンノキン
址	シ，シロアトヲイミスルジョウシノシ
坂	サカミチ ノ サカ
均	ヘイキン ノ キン
坊	ボウズ ノ ボウ
坎	カン，アナ，ツチヘンニホケツノケツ
坏	タカツキノツキ
坐	ザセキ ノ ザカラマダレヲトッタザ，スワル
坑	タンコウ ノ コウ，アナ
坡	ハ，ツチヘンニケガワノカワ
坤	ケンコン ノ コン，ツチヘン ニ モウス
坦	ヘイタンナミチ ノ タン
坩	カン，ルツボ，ツチヘンニアマイ
坪	タテツボ ノ ツボ
坿	フ，ツチヘンニフロクノフ
垂	スイチョク ノ スイ，タレル
垈	タイ，ダイヒョウシャノダイノシタニツチ
垉	ホウ，ツチヘンニツツム
型	モケイ ノ ケイ，カタ
垓	カズノタンイノガイ
垠	ギン，ツチヘンニダイコンノコンノツクリ
垢	テアカ ノ アカ，コウ
垣	カキネ ノ カキ
垤	テツ，アリヅカ，ツチヘンニゲシノシ
垪	ハ，ツチヘンニヘイゴウノヘイノツクリ
垰	タオ，ツチヘンニウエトシタ
垳	ガケ，ツチヘンニリョコウスルノコウ
埀	スイチョクノスイ，タレルノイタイジ
埃	ホコリマミレノホコリ，ジンアイノアイ
埆	カク，ツチヘンニツノ
埋	ウメル，マイボツスル ノ マイ
城	ジョウカマチ ノ ジョウ，シロ
埒	ラチガアカナイノラチ
埓	ラチガアカナイノラチノイタイジ
埔	ホ，ツチヘンニシジンノトホノホ
埖	ゴミ，ツチヘンニハナビノハナ
埜	ヤ，ハヤシ ノ シタニ ツチ
域	チイキ ノ イキ
埠	ミナト ノ フトウ ノ フ
埣	サイ，ツチヘンニソツギョウノソツ
埴	ハニワ ノ ハニ
執	シツジ ノ シツ，トル
培	サイバイスル ノ バイ，ツチカウ
基	キホン ノ キ，モトヅク
埼	サイタマケン ノ イチモジメ ノ サキ
堀	ホリバタ ノ ホリ
堂	コッカイギジドウ ノ ドウ
堅	ケンジツナ ノ ケン，カタイ
堆	タイセキブツ ノ タイ
堊	アク，アネッタイノアノキュウジタイノシタニツチ
堋	ホウ，ツチヘンニホウユウノホウ
堕	ダラクスル ノ ダ
堙	イン，ツチヘンニエントツノエンノツクリ
堝	カ，ツチヘンニナベノツクリ
堡	キョウトウホのホ，ホケンシツノホノシタニツチ
堤	テイボウ ノ テイ，ツツミ
堪	カンニンブクロ ノ カン，タエル
堯	ギョウシュンノギョウノキュウジ
堰	エンテイ ノ エン，セキ
報	ホウドウ ノ ホウ
場	バショ ノ バ，ジョウ
堵	アンドスル ノ ト
堺	オオサカフサカイシ ノ サカイ
堽	コウ，ツチヘンニアミガシラニタダシイ
塀	ヘイ，イタベイ ノ ヘイ
塁	マンルイ ノ ルイ
塊	ダンカイ ノ カイ，カタマリ
塋	エイ，ハカ，エイギョウノエイノキュウジノロノカワリニツチ
塑	カソセイ ノ ソ
塒	ジ，ネグラ，ツチヘンニニチジノジ
塔	ゴジュウ ノ トウ
塗	トソウ ノ ト，ヌル
塘	トウ，ツチヘン ニ ケントウシ ノ トウ
塙	ハナワ，ツチヘン ニ タカイ
塚	ツカ，カイヅカ ノ ツカ
塞	ノウコウソク ノ ソク，フサガル
塢	オ，ツチヘンニウゴウノシュウノウ
塩	ショクエン ノ エン，シオ
填	ジュウテンスル ノ テン，ハメル
塰	アマ，ウミノシタニツチ
塲	バショノバノイタイジ
塵	フンジン ノ ジン，チリ
塹	ザンゴウノザン
塾	ガクシュウジュク ノ ジュク
境	コッキョウ ノ キョウ，サカイ
墅	ショ，ノハラノノノシタニツチ
墓	ボチ ノ ボ，ハカ
増	ゾウカスル ノ ゾウ，フエル
墜	ツイラクスル ノ ツイ
墟	ハイキョノキョ
墨	ボクジュウ ノ ボク，スミ
墫	タルノイタイジ
墮	ダラクスルノダノキュウジ
墳	コフン ノ フン
墸	ツチヘンニチョシャノチョノキュウジタイ
墹	ママ，ツチヘンニアイダ
墺	オウ，ツチヘンニオクバノオクノキュウジ
墻	ショウ，ツチヘンニリンショクノショク
墾	カイコンチ ノ コン
壁	ヘキガ ノ ヘキ，カベ
壅	ヨウ，ヨウリツスルノヨウノツクリノシタニツチ
壇	ブツダン ノ ダン
壊	ハカイ ノ カイ，コワス
壌	ドジョウカイリョウ ノ ジョウ
壑	タニヲイミスルガク
壓	アツリョクノアツノキュウジ
壕	ボウクウゴウ ノ ゴウ
壗	ママ，ツチヘンニワガママノママノツクリ
壘	ルイセキスルノルイノキュウジ
壙	コウ，ツチヘンニヒロバノヒロノキュウジ
壜	ビン，ツチヘンニクモリ
壞	コワス，ハカイノカイノキュウジ
壟	ロウ，キョウリュウノリュウノキュウジノシタニツチ
壤	ドジョウカイリョウノジョウノキュウジ
壥	ツチヘンニガンダレニボクジュウノボクノキュウジ
士	ベンゴシ ノ シ
壬	ジンシンノラン ノ ジン
壮	ソウダイナ ノ ソウ
壯	ソウダイナノソウノキュウジ
声	コエ，オンセイ ノ セイ
壱	ケイヤクショニ ツカウ スウジ ノ イチ
売	ショウバイ ノ バイ，ウル
壷	オモウツボ ノ ツボ
壹	ケイヤクショノツカウスウジイチノキュウジ
壺	オモウツボノツボノセイジ
壻	ハナムコノムコノイタイジ，ツチヘン
壼	コン，サムライノシタニワカンムリ，アネッタイノアノキュウジ
壽	コトブキ，ジュミョウノジュノキュウジ
夂	チ，ブシュノフユガシラ
変	ヘンカ ノ ヘン，カエル
夊	スイ，ブシュノスイニョウ
夏	ナツヤスミ ノ ナツ，カ
夐	ケイ，スイニョウノハルカ
夕	ユウガタ ノ ユウ
外	ガイコク ノ ガイ，ソト
夘	ジュウニシノウノイタイジ
夙	ツトニ，シュク
多	オオイスクナイ ノ オオイ，タ
夛	オオイスクナイノオオイノイタイジ
夜	コンヤ ノ ヤ，ヨル
夢	ユメ，ムチュウ ノ ム
夥	カ，オビタダシイ
大	ダイショウ ノ ダイ，オオキイ
天	テンキヨホウ ノ テン
太	フトイホソイ ノ フトイ，タイ
夫	オット，フサイ ノ フ
夬	カイ，ワケル，タスウケツノケツノツクリ
夭	ヨウセツスルノヨウ，ワカイ
央	チュウオウ ノ オウ
失	シツレン ノ シツウシナウ
夲	トウ，オオキイノシタニスウジノジュウ
夷	ジョウイ ノ イ，エビス
夸	カ，コチョウスルノコノツクリ
夾	キョウ，ハサムノキュウジノツクリ
奄	アマミオオシマ ノ イチモジメ ノ エン
奇	キミョウナ ノ キ
奈	ナラケン ノ ナ
奉	ホウシカツドウ ノ ホウ，タテマツル
奎	ケイ，オオキイノシタニツチフタツ
奏	エンソウスル ノ ソウ，カナデル
奐	カン，カンキセンノカンノツクリ
契	ケイヤクスル ノ ケイ
奔	ホンソウスル ノ ホン
奕	イゴヲイミスルエキ
套	ジョウトウシュダン ノ トウ
奘	サンゾウホウシゲンジョウノジョウ
奚	ケイ，ケイリュウヅリノケイノキュウジノツクリ
奠	オコウデンノデン，シュウチョウノシュウノシタニオオキイ
奢	ゴウシャノシャ，オゴリ
奥	オクバ ノ オク
奧	オクバノオクノキュウジ
奨	ショウガクキン ノ ショウ
奩	レン，ハコ，オオキイノシタニクベツノクノキュウジ
奪	ウバウ，リャクダツ ノ ダツ
奬	ショウガクキンノショウノキュウジ
奮	コウフン ノ フン，フルウ
女	オンナ，ジョシ ノ ジョ
奴	ドレイ ノ ド，ヤツ
奸	カン，オンナヘンニホス
好	ダイスキ ノ スキ，コウ
妁	シャク，オンナヘンニヨウセキノタンイノシャク
如	トツジョ ノ ジョ
妃	オウヒ ノ ヒ，キサキ
妄	コダイモウソウ ノ モウ
妊	ニンシンスル ノ ニン
妍	ケン，オンナヘンニケンキュウノケンノツクリ
妓	ゲイギ ノ ギ，オンナヘン ニ ササエル
妖	モリ ノ ヨウセイ ノ ヨウ
妙	キミョウナ ノ ミョウ
妛	ヤマノシタニカンスウジノイチ，ソノシタニオンナ
妝	ショウ，ショウグンノショウノキュウジノヒダリガワニオンナ
妣	ヒ，オンナヘンニヒカクスルノヒ
妥	ダキョウスル ノ ダ
妨	ボウガイスル ノ ボウ，サマタゲル
妬	シットスル ノ ト，ネタム
妲	ダツ，オンナヘンニガンタンノタン
妹	イモウト，シマイ ノ マイ
妻	フサイ ノ サイ，ツマ
妾	メカケ，ショウ
姆	ボ，オンナヘンニハハ
姉	アネ，シマイ ノ シ
始	カイシスル ノ シ，ハジメル
姐	アネゴハダ ノ アネ
姑	コソク ノ コ，シュウトメ
姓	セイメイハンダン ノ セイ
委	ガッキュウイイン ノ イ
姙	ニン，ニンシンスルノニンノイタイジ
姚	ヨウ，オンナヘンニイッチョウエンノチョウ
姜	ショウガノニモジメ，ヒツジノシタニオンナ
姥	ウバザクラ ノ ウバ
姦	カシマシイ，オンナミッツ ノ カン
姨	イ，オンナヘンニソンノウジョウイノイ
姪	オイメイ ノ メイ
姫	オヒメサマ ノ ヒメ
姶	オンナヘン ニ ゴウカク ノ ゴウ
姻	コンイン ノ イン
姿	スガタ，シセイ ノ シ
威	イゲンガアル ノ イ
娃	アイ，オンナヘン ニ ツチ フタツ
娉	ヘイ，オンナヘンニショウヘイスルノヘイ
娑	シャバニデルノシャ
娘	ヒトリムスメ ノ ムスメ
娚	ナン，オンナヘンニオトコ
娜	アダッポイノダ
娟	ケン，オンナヘンニキヌイトノキヌノツクリ
娠	ニンシンスル ノ シン
娥	ガ，オンナヘンニガマンノガ
娩	ブンベンスル ノ ベン
娯	ゴラク ノ ゴ
娵	シュ，オンナヘンニシュザイノシュ
娶	メトル，シュ
娼	ショウフ ノ ショウ，オンナヘン ニ ヒガ フタツ
婀	アダッポイノア
婁	ロウカク ノ ロウ ノ キュウジ ノ ツクリ
婆	ロウバシン ノ バ
婉	エンキョクヒョウゲンノエン
婚	ケッコンスル ノ コン
婢	ヒ，オンナヘンニヒクツナノヒ
婦	フウフ ノ フ
婪	ドンランナノラン，ハヤシノシタニオンナ
婬	イン，オンナヘンニインランノインノツクリ
婿	ハナムコ ノ ムコ
媒	バイカイスル ノ バイ
媚	ビヤクノビ，コビル
媛	エヒメケン ノ ヒメ
媼	オウ，オンナヘンニオンセンノオンノキュウジノツクリ
媽	ボ，オンナヘンニウマ
媾	コウ，オンナヘンニミゾノツクリ
嫁	ハナヨメ ノ ヨメ
嫂	ソウ，アニヨメ
嫉	シットスル ノ シツ，ソネム
嫋	ジョウ，タオヤカ
嫌	キラウ，ケンオ ノ ケン
嫐	ドウ，ナヤマシイ，オンナ，オトコ，オンナ
嫖	ヒョウ，オンナヘンニトウヒョウノヒョウ
嫗	オウ，オンナヘンニクベツノクノキュウジ
嫡	チャクナン ノ チャク
嫣	エン，オンナヘンニシュウエンノチノエン
嫦	ジョウ，オンナヘンニヒジョウグチノジョウ
嫩	ドン，オンナヘンニセイリスルノセイノウエガワ
嫺	カン，オンナヘンニモンガマエニツキ
嫻	カン，オンナヘンニモンガマエニモクヨウビノモク
嬉	ウレシイ，キ
嬋	セン，オンナヘンニタンジュンノタンノキュウジ
嬌	アイキョウガアルノキョウ
嬖	ヘイ，ヘキエキスルノヘキノシタニオンナ
嬢	オジョウサマ ノ ジョウ
嬪	ベッピンノヒン
嬬	ツマ，オンナヘン ニ ヒツジュヒン ノ ジュ
嬰	アカンボウヲ イミスル エイジ ノ エイ
嬲	ジョウ，ナブル，オトコ，オンナ，オトコ
嬶	カカア，オンナヘンニハナカゼノハナ
嬾	ラン，オンナヘンニタヨルノキュウジ
孀	ソウ，ヤモメ，オンナヘンニシモバシラノシモ
孃	オジョウサマノジョウノキュウジ
孅	セン，オンナヘンニクジビキノクジノシタガワ
子	コドモ ノ コ
孑	ノコリヲイミスルケツ，コドモノコノミギウデガカケタカタチ
孔	コウシモウシ ノ コウ
孕	ハラム，ヨウ
字	ローマジ ノ ジ
存	ソンザイスル ノ ソン
孚	フ，ハグクム，ツメノシタニコドモノコ
孛	ボツ，ボッパツスルノヒダリガワ
孜	ツトム，コヘン ニ ノブン
孝	オヤフコウ ノ コウ
孟	コウシモウシ ノ モウ
季	キセツフウ ノ キ
孤	コドク ノ コ
孥	ド，ヤッコノシタニコドモノコ
学	マナブ，ガクシュウ ノ ガク
孩	ガイ，コヘンニジュウニシノイノシシ
孫	マゴノテ ノ マゴ，ソン
孰	シュク，ガクシュウジュクノジュクカラツチヲトッタカタチ
孱	サン，シカバネニコドモノコガミッツ
孳	ジ，ジヒブカイノジノココロノカワリニコドモノコ
孵	タマゴガフカスルノフ
學	マナブ，ガクシュウノガクノキュウジ
孺	ジュ，コヘンニヒツジュヒンノジュ
宀	ベン，ブシュノウカンムリ
它	タ，ヘビカラムシヘンヲトッタカタチ
宅	ジュウタク ノ タク
宇	ウチュウ ノ ウ
守	シュビ ノ シュ，マモル
安	アンシン ノ アン，ヤスイ
宋	チュウゴク ノ コクメイ ノ ソウ
完	カンリョウスル ノ カン
宍	シシ，ウカンムリ ニ カンスウジ ノ ロク
宏	ウカンムリ ニ ナム ノ コウ
宕	トウ，アタゴ ノ ニモジメ，ウカンムリ ニ イシ
宗	シュウキョウカイカク ノ シュウ
官	ケイサツカン ノ カン
宙	ウチュウセン ノ チュウ
定	ヨテイ ノ テイ，サダメル
宛	アテナ ノ アテ
宜	ベンギ ノ ギ，ヨロシク
宝	ホウセキ ノ ホウ，タカラ
実	ジツリョク ノ ジツ，ミ
客	オキャク ノ キャク
宣	センデン ノ セン
室	キョウシツ ノ シツ
宥	ナダメル，ユウジョ ノ ユウ
宦	カンガンノカン，ウカンムリニソウリダイジンノジン
宮	オミヤマイリ ノ ミヤ，キュウ
宰	ソウリヲ イミスル サイショウ ノ サイ
害	サイガイ ノ ガイ
宴	エンカイ ノ エン，ウタゲ
宵	ヨイノクチ ノ ヨイ
家	イエ，カゾク ノ カ
宸	シン，ウカンムリニジュウニシノタツ
容	ヨウセキ ノ ヨウ
宿	シュクハク ノ シュク，ヤド
寂	セイジャク ノ ジャク，サビシイ
寃	エンザイヲハラスノエンノイタイジ
寄	キフスル ノ キ，ヨル
寅	トラ，ジュウニシ ノ トラ
密	ヒミツ ノ ミツ
寇	モウコシュウライノゲンコウノコウ
寉	トリノツルノイタイジ，ウカンムリニフルトリ
富	ホウフ ノ フ，トム
寐	ムビノビ，ネムル
寒	アツイサムイ ノ サムイ，カン
寓	グウワ ノ グウ
寔	ショク，ウカンムリニゼヒノゼ
寛	カンダイナ ノ カン，ヒロイ
寝	シンシツ ノ シン，ネル
寞	セキバクノバク
察	ケイサツ ノ サツ
寡	カモクナ ノ カ，スクナイ
寢	シンシツノシン，ネルノキュウジ
寤	サメルヲイミスルゴ
寥	セキリョウカンノリョウ
實	ジツリョクノジツ，ミノキュウジ
寧	テイネイ ノ ネイ
寨	サイ，サムイノシタニテンノカワリニモクザイノモク
審	シンサスル ノ シン
寫	シャシンノシャ，ウツスノキュウジ
寮	ガクセイリョウ ノ リョウ
寰	カン，ウカンムリニシゼンカンキョウノカンノツクリ
寳	ホウセキノホウ，タカラノキュウジノイタイジ
寵	チョウアイヲウケル ノ チョウ
寶	ホウセキノホウ，タカラノキュウジ
寸	スンポウ ノ スン
寺	テラ，ジイン ノ ジ
対	ハンタイ ノ タイ
寿	コトブキ，ジュミョウ ノ ジュ
封	フウトウ ノ フウ
専	センモン ノ セン
射	ハンシャ ノ シャ
尅	ゲコクジョウノコクノイタイジ，コクフクスルノコクニスン
将	ショウグン ノ ショウ
將	ショウグンノショウノキュウジ
專	センモンノセンノキュウジ
尉	リクグンタイイ ノ イ
尊	ソンケイスル ノ ソン，トウトブ
尋	ジンモンスル ノ ジン，タズネル
對	ハンタイノタイノキュウジ
導	ユウドウ ノ ドウ，ミチビク
小	ダイショウ ノ ショウ，チイサイ
少	オオイスクナイ ノ ショウ，ショウ
尓	ジ，アミダブツノミノツクリ
尖	トガル，センエイ ノ セン
尚	オショウサン ノ ショウ
尠	セン，ハナハダシイニスクナイ
尢	オウ，ブシュノマゲアシ
尤	セツゾクシ ノ モットモ
尨	ボウ，ムクイヌ
尭	ギョウシュン ノ ギョウ
就	シュウショク ノ シュウ，ツク
尸	シ，ブシュノシカバネ
尹	イン，イセエビノイノツクリ
尺	シャクハチ ノ シャク
尻	シリゴミスル ノ シリ
尼	アマデラ ノ アマ，ニ
尽	ジンリョクスル ノ ジン，ツクス
尾	ビコウスル ノ ビ，オッポ ノ オ
尿	トウニョウビョウ ノ ニョウ
局	ユウビンキョク ノ キョク
屁	ヒ，ヘリクツノヘ
居	ジュウキョ ノ キョ，イル
屆	トドケルノキュウジ
屈	リクツ ノ クツ
届	トドケル
屋	オクジョウ ノ オク，ヤ
屍	シカバネ
屎	シニョウノシ，クソ
屏	ビョウブノビョウ
屐	ゲキ，キグツ，シカバネニギョウニンベンニシエンスルノシ
屑	クズイレ ノ クズ
屓	ヒイキノキ，シカバネニカイガラノカイ
展	ハッテン ノ テン
属	フゾク ノ ゾク
屠	トサツスル ノ ト，ホフル
屡	シバシバ
層	コウソウビル ノ ソウ
履	リレキショ ノ リ
屬	フゾクノゾクノキュウジ
屮	ヒダリヲイミスルサ，ヤマノナガイタテボウガシタニヌケル
屯	チュウトンスル ノ トン
山	ヤマ，サンミャク ノ サン
屶	カイ，ナタ，ヤマノシタニカタナ
屹	キツリツスルノキツ
岌	キュウ，ヤマノシタニフキュウスルノキュウ
岐	ブンキテン ノ キ
岑	シン，ヤマノシタニコンゲツノコン
岔	タ，ハンブンノブンノシタニヤマ
岡	オカヤマケン ノ オカ
岨	ケンソ ノ ソ，ヤマヘン ニ カツ
岩	イワ，ガンセキ
岫	シュウ，イワアナ，ヤマヘンニリユウノユウ
岬	エリモミサキ ノ ミサキ
岱	ダイヒョウ ノ ダイ ノ シタニ ヤマ，タイ
岳	サンガク ノ ガク，タケ
岶	ハク，ヤマヘンニシロイ
岷	ビン，ヤマヘンニコクミンノミン
岸	カイガン ノ ガン，キシ
岻	チ，ヤマヘンニヒクイノツクリ
岼	ユリ，ヤマヘンニタイラ
岾	ハケ，ヤマヘンニドクセンスルノセン
峅	クラ，ヤマヘンニベントウノベン
峇	コウ，ヤマノシタニゴウカクノゴウ
峙	タイジスルノジ，ヤマヘンニテラ
峠	トウゲ ノ チャヤ ノ トウゲ
峡	ツガルカイキョウ ノ キョウ
峨	ヤマヘン ニ ワレ ノ ガ
峩	ヤマヘンニワレノガノイタイジ
峪	ヨク，ヤマヘンニタニ
峭	ショウ，ヤマヘンニショウゾウガノショウ
峯	ヤマカンムリ ノ ミネ，ホウ
峰	サイコウホウ ノ ホウ，ミネ
島	シマグニ ノ シマ，トウ
峺	コウ，ヤマヘンニサラシナノサラ
峻	キュウシュンナ ノ シュン
峽	ツガルカイキョウノキョウノキュウジ
崇	スウハイスル ノ スウ，アガメル
崋	ワタナベカザンノカ
崎	ナガサキ ノ サキ
崑	コンロンサンミャクノコン，ヤマノシタニコンチュウノコン
崔	サイ，ヤマノシタニフルトリ
崕	ガケ，ダンガイノガイノイタイジ
崖	ガケ，ダンガイ ノ ガイ
崗	カコウガンノコウ，オカヤマケンノオカノイタイジ
崘	コンロンサンミャクノロンノイタイジ
崙	コンロンサンミャクノロン
崚	リョウ，ヤマヘンニリョウセンノリョウノツクリ
崛	クツ，ヤマヘンニリクツノクツ
崟	ギン，ヤマノシタニキンヨウビノキン
崢	ソウ，ヤマヘンニアラソウノキュウジ
崩	ホウカイスル ノ ホウ，クズレル
嵋	ビ，ヤマヘンニマユゲノマユ
嵌	ハメキザイクノハメル，カン
嵎	グウ，ヤマヘンニグウゼンノグウノツクリ
嵐	アラシヤマ ノ アラシ
嵒	ガン，シナモノノシナノシタニヤマ
嵜	ナガサキケンノサキノイタイジ
嵩	カサアゲスル ノ カサ
嵬	カイ，ヤマノシタニオニ
嵯	サガテンノウ ノ サ
嵳	サ，ヤマノシタニサベツカスルノサ
嵶	タワ，ヤマヘンニヨワイ
嶂	ショウ，ヤマヘンニブンショウヲカクノショウ
嶄	ザン，ヤマノシタニザンシンナノザン
嶇	ク，ヤマヘンニクベツスルノクノキュウジ
嶋	トウ，ヤマヘン ニ トリ ノ シマ
嶌	トウ，シマグニノシマノイタイジ，ヤマノシタニトリ
嶐	リュウ，ヤマノシタニリュウキスルノリュウニイッカククワエタカタチ
嶝	トウ，ヤマヘンニトザンノト
嶢	ギョウ，ヤマヘンニギョウシュンノギョウノキュウジ
嶬	ギ，ヤマヘンニギムノギ
嶮	ケン，ヤマヘンニシケンヲウケルノケンノキュウジノツクリ
嶷	ギ，ヤマノシタニギモンノギ
嶺	サンレイ ノ レイ，ミネ
嶼	ショ，ヤマヘンニアタエルノキュウジ
嶽	サンガクブノガクノキュウジ
巉	ザン，ヤマヘンニザンゲンスルノザンノツクリ
巌	ガンリュウジマ ノ ガン，イワオ
巍	ギ，ヤマノシタニギシワジンデンノギ
巒	ラン，コイビトノコイノキュウジノココロノカワリニヤマ
巓	ヤマノイタダキヲイミスルサンテンノテン
巖	ゲンジュウナノゲン，キビシイノキュウジ
巛	セン，ブシュノマガリガワ
川	カセン ノ セン，カワ
州	キュウシュウチホウ ノ シュウ
巡	ジュンカイ ノ ジュン，メグル
巣	ハチノス ノ ス
工	ズコウ ノ コウ
左	ヒダリ，サユウ ノ サ
巧	ギコウテキナ ノ コウ，タクミ
巨	キョダイナ ノ キョ
巫	ジンジャノミコノフ
差	サベツカスル ノ サ
己	ジコショウカイ ノ コ，オノレ
已	ブンポウノイゼンケイノイ
巳	ミ，ジュウニシ ノ ミ
巴	トモエナゲ ノ トモエ
巵	シ，サカズキノイタイジ
巷	チマタ ノ コエ ノ チマタ，コウ
巻	ノリマキ ノ マキ
巽	ホウガク ノ タツミ
巾	ゾウキン ノ キン，ハバ
市	シヤクショ ノ シ，イチ
布	ヌノ，モウフ ノ フ
帆	ハンセン ノ ハ，ホバシラ ノ ホ
帋	ガヨウシノシ，カミノイタイジ
希	キボウ ノ キ，マレ
帑	ド，ヤッコノシタニハバ
帖	テチョウ ノ チョウ，ハバニウラナウ
帙	チツ，ハバヘンニウシナウ
帚	ホウキ，ソウジキノソウノツクリ
帛	ハク，ハクチョウノハクノシタニハバ
帝	テイオウ ノ テイ，ミカド
帥	ダイゲンスイ ノ スイ
師	ボクシ ノ シ
席	ザセキ ノ セキ
帯	ケイタイ ノ タイ，オビ
帰	キタクスル ノ キ，カエル
帳	レンラクチョウ ノ チョウ
帶	ケイタイノタイ，オビノキュウジ
帷	カタビラ，ハバヘンニフルトリ
常	ヒジョウグチ ノ ジョウ
帽	ダツボウスル ノ ボウ
幀	テイ，ハバヘンニテイシュクナノテイ
幃	イ，ハバヘンニイダイナノイノツクリ
幄	アク，ハバヘンニオクジョウノオク
幅	ゾウフクスル ノ フク，ハバ
幇	ホウジョスルノホウ
幌	ホロバシャ ノ ホロ
幎	ベイ，ハバヘンニメイフクヲイノルノメイ
幔	マンマクノマン，ハバヘンニウナギノツクリ
幕	ジマク ノ マク
幗	カク，ハバヘンニクニノキュウジ
幟	キシヲセンメイニスルノシ，ノボリ
幡	ヤハタ ノ ハタ
幢	トウ，ハバヘンニグリムドウワノドウ
幣	ゾウヘイキョク ノ ヘイ
幤	ゾウヘイキョクノヘイノイタイジ
干	カンチョウ ノ カン，ホス
平	ヘイワ ノ ヘイ，タイラ
年	ガクネン ノ ネン，トシ
幵	ケン，ホスガフタツ
并	ヘイ，ヘイヨウスルノヘイノツクリ
幸	コウフク ノ コウ，シアワセ
幹	シンカンセン ノ カン，ミキ
幺	ヨウ，ブシュノイトガシラ
幻	マボロシ，ゲンソウ ノ ゲン
幼	ヨウチエン ノ ヨウ，オサナイ
幽	ユウレイセン ノ ユウ
幾	キカガク ノ キ
广	ゲン，ブシュノマダレ
庁	キショウチョウ ノ チョウ
広	ヒロバ ノ ヒロ，コウ
庄	ショウヤ ノ ショウ
庇	ヒゴスル ノ ヒ，ヒサシ
床	トコヤ ノ トコ，ショウ
序	ジュンジョ ノ ジョ
底	ソコヂカラ ノ ソコ，テイ
庖	マダレ ノ ホウチョウ ノ ホウ
店	ミセ，ショウテン ノ テン
庚	コウシンヅカ ノ コウ，カノエ
府	トドウフケン ノ フ
庠	ショウ，マダレニヒツジ
度	オンドケイ ノ ド
座	ザセキ ノ ザ，スワル
庫	レイゾウコ ノ コ
庭	テイエン ノ テイ，ニワ
庵	イオリ，タクアン ノ アン
庶	ショミン ノ ショ
康	ケンコウ ノ コウ，イエヤス ノ ヤス
庸	ボンヨウナ ノ ヨウ
廁	カワヤ，マダレニホウソクノソク
廂	ショウ，マダレニソウダンスルノソウ
廃	ハイシスル ノ ハイ，スタレル
廈	カ，マダレニナツ
廉	レンカバン ノ レン
廊	ワタリロウカ ノ ロウ
廏	キュウシャノキュウ，ウマヤノイタイジ，ルマタ
廐	キュウシャノキュウ，ウマヤノイタイジ，キバ
廓	ユウカク ノ カク，クルワ
廖	リョウ，マダレニゴビュウノビュウノツクリ
廚	チュウボウノチュウ，クリヤノキュウジ
廛	テン，マトイノツクリ
廝	シ，マダレニシカイノケンイノシ
廟	レイビョウ ノ ビョウ
廠	カイグンコウショウ ノ ショウ
廡	ブ，マダレニムリノム
廢	ハイシスルノハイ，スタレルノキュウジ
廣	ヒロバノヒロノキュウジ
廨	カイ，マダレニカイケツスルノカイ
廩	リン，マダレニリンギスルノリン
廬	ロザンノロ，マダレニハゼノキノハゼノツクリ
廰	チョウ，キショウチョウノチョウノキュウジノイタイジ
廱	ヨウ，マダレニカワ，クチ，トモエ，フルトリ
廳	チョウ，キショウチョウノチョウノキュウジ
廴	イン，ブシュノエンニョウ
延	エンキスル ノ エン，ノビル
廷	キュウテイブンガク ノ テイ
廸	テキ，エンニョウニリユウノユウ
建	ケンチク ノ ケン，タテル
廻	エンニョウ ニ マワル ノ カイ
廼	エンニョウ ニ ニシ，ナイ
廾	キョウ，ブシュノニジュウアシ
廿	カンスウジ ノ ニジュウ
弁	ベントウ ノ ベン
弃	ハイキスルノキ，ステルノイタイジ
弄	ホンロウスル ノ ロウ，モテアソブ
弉	サンゾウホウシゲンジョウノジョウノイタイジ
弊	ヘイガイ ノ ヘイ
弋	ヨク，ブシュノシキガマエ
弌	イチ，カンスウジノイチノイタイジ，シキガマエニイチ
弍	カンスウジノニノイタイジ，シキガマエニニ
式	ニュウガクシキ ノ シキ
弐	ケイヤクショニ ツカウ スウジ ノ ニ
弑	シギャクスルノシ，コロスノヒダリガワニニュウガクシキノシキ
弓	ユミヤ ノ ユミ
弔	トムラウ，チョウジ ノ チョウ
引	インヨウスル ノ イン，ヒク
弖	テニヲハノテ，ユミノシタニカンスウジノイチ
弗	フッソ ノ フツ，ドル
弘	コウボウタイシ ノ コウ，ヒロイ
弛	ユルム，シカンスル ノ シ
弟	アニオトオト ノ オトオト
弥	アミダブツ ノ ミ
弦	ゲンガッキ ノ ゲン，ツル
弧	コヲエガク ノ コ
弩	チョウドキュウノド，ヤッコノシタニユミ
弭	ビ，ユミヘンニミミ
弯	ワンガンノワンノツクリ
弱	キョウジャク ノ ジャク，ヨワイ
張	キンチョウスル ノ チョウ，ハル
強	ベンキョウ ノ キョウ，ツヨイ
弸	ホウ，ユミヘンニホウユウヲイミスルホウ
弼	ホヒツ ノ ヒツ，スケ
弾	ダンリョク ノ ダン，ハズム
彁	ユミヘンニカノウセイノカヲカサネル
彈	ダンリョクノダン，ハズムノキュウジ
彊	ジキョウジュツ ノ キョウ，ツヨイ
彌	アミダブツノミノキュウジ
彎	ワンガンノワンノキュウジノツクリ
彑	ケイ，ブシュノケイガシラ
当	トウバン ノ トウ，アタル
彖	タン，ケイガシラニイノコ
彗	ハレースイセイノスイ
彙	キホンゴイノイ
彜	イ，ゴイノイノウエガワニコナ，ニジュウアシ
彝	イ，ゴイノイノウエガワニコメ，イト，ニジュウアシ
彡	サン，ブシュノサンヅクリ
形	チョウホウケイ ノ ケイ，カタチ
彦	ヒコボシ ノ ヒコ
彩	シキサイ ノ サイ，イロドル
彪	トラニサンヅクリ ノ ヒョウ
彫	チョウコクカ ノ チョウ，ホル
彬	ヒン，ハヤシニ サンヅクリ，アキラ
彭	ホウ，ボウチョウリツノボウノツクリ
彰	ヒョウショウジョウ ノ ショウ
影	エイキョウ ノ エイ，カゲ
彳	テキ，ブシュノギョウニンベン
彷	ホウコウスルノホウ，ギョウニンベンニオヤカタノカタ
役	ヤクワリ ノ ヤク
彼	ヒガンバナ ノ ヒ，カレ
彿	フツ，ギョウニンベンニドル
往	オウフク ノ オウ
征	エンセイグン ノ セイ
徂	ジュガクシャノオギュウソライノソ
徃	オウフクスルノオウノイタイジ
径	エン ノ ハンケイ ノ ケイ
待	キタイスル ノ タイ，マツ
徇	ジュン，ギョウニンベンニゲジュンノジュン
很	コン，ギョウニンベンニダイコンノコンノツクリ
徊	ハイカイスルノカイ，ギョウニンベンニマワル
律	ホウリツ ノ リツ
後	ウシロ，ゼンゴ ノ ゴ
徐	ジョコウスル ノ ジョ
徑	エンノハンケイノケイノキュウジ
徒	トホ ノ ト
従	ジュウジスル ノ ジュウ，シタガウ
得	トクイ ノ トク，エル
徘	ハイカイスルノハイ，サマヨウ
徙	シ，ギョウニンベンニトメルニハシルノシタガワ
從	ジュウジスルノジュウ，シタガウノキュウジ
徠	ジュガクシャノオギュウソライノライ
御	オンチュウ ノ オン，ゴハン ノ ゴ
徨	ホウコウスルノコウ，サマヨウ
復	オウフク ノ フク
循	アクジュンカン ノ ジュン
徭	ヨウ，ギョウニンベンニユレルノキュウジノツクリ
微	ビセイブツ ノ ビ
徳	ドウトク ノ トク
徴	トクチョウテキナ ノ チョウ
徹	テツヤスル ノ テツ
徼	キョウ，ギョウニンベンニゲキレイスルノゲキノツクリ
徽	キショウヲツケル ノ キ，シルシ
心	ココロ，アンシン ノ シン
必	ヒツヨウ ノ ヒツ，カナラズ
忌	イッシュウキ ノ キ，イム
忍	ニンジャ ノ ニン，シ ノ ブ
忖	ソンタクスルノソン，リッシンベンニスンポウノスン
志	ココロザス，イシ ノ シ
忘	ボウネンカイ ノ ボウ，ワスレル
忙	イソガシイ，タボウ ノ ボウ
応	オウエン ノ オウ
忝	テン，カタジケナイ，テンプスルノテンノツクリ
忠	チュウコクスル ノ チュウ
忤	ゴ，リッシンベンニショウゴノゴ
快	カイテキ ノ カイ，ココロヨイ
忰	ショウスイスルノスイノイタイジ
忱	シン，リッシンベンニチンボツスルノチンノツクリ
念	ザンネン ノ ネン
忸	ジクジタルノジク，ハジル
忻	キン，リッシンベンニパンイッキンノキン
忽	コツゼン ノ コツ，タチマチ
忿	フン，フンベツノフンノシタニココロ
怎	ソウ，サクヤノサクノツクリノシタニココロ
怏	オウ，リッシンベンニチュウオウノオウ
怐	コウ，リッシンベンニハイクノク
怒	ゲキドスル ノ ド，イカル
怕	ハ，オソレル，リッシンベンニシロイ
怖	キョウフ ノ フ，コワイ
怙	エコヒイキノコ，リッシンベンニチュウコシャノコ
怛	ダツ，リッシンベンニガンタンノタン
怜	リッシンベン ニ メイレイ ノ レイ
思	フシギ ノ シ，オモウ
怠	タイマン ノ タイ，ナマケル
怡	イ，リッシンベンニダイドコロノダイ
急	トッキュウ ノ キュウ，イソグ
怦	ヒョウ，リッシンベンニヘイワノヘイ
性	コセイテキ ノ セイ
怨	オンネン ノ オン，ウラミ
怩	ジクジタルノジ，ハジル
怪	カイブツ ノ カイ，アヤシイ
怫	フツ，リッシンベンニドル
怯	ヒキョウモノ ノ キョウ，オビエル
怱	ソウ，ネギノクサカンムリノシタガワ
怺	エイ，リッシンベンニエイキュウノエイ
恁	ジン，セキニンノニンノシタニココロ
恂	ジュン，リッシンベンニゲジュンノジュン
恃	キョウジヲタモツノジ
恆	コウオンドウブツノコウ，ツネニノキュウジ
恊	キョウリョクスルノキョウノイタイジ
恋	コイビト ノ コイ，レン
恍	コウコツノヒトノコウ
恐	キョウフ ノ キョウ，オソロシイ
恒	コウオンドウブツ ノ コウ，ツネニ
恕	カンジョ ノ ジョ，ユルス
恙	ヨウ，ツツガナククラスノツツガ
恚	イ，ツチフタツノシタニココロ
恟	キョウ，リッシンベンニカラダノムネノツクリ
恠	カイブツノカイノイタイジ，リッシンベンニソンザイノザイ
恢	テンモウカイカイ ノ カイ
恣	シイテキナノシ，ホシイママ
恤	ジュツ，リッシンベンニケツエキノケツ
恥	ハジヲカク ノ ハジ
恨	ウラミ，ツウコン ノ コン
恩	オンガエシ ノ オン
恪	カク，リッシンベンニカクジノカク
恫	ドウカツスルノドウ
恬	ムヨクテンタンノテン
恭	キョウジュン ノ キョウ，ウヤウヤシイ
息	イキヲスル ノ イキ，ソク
恰	カップクガヨイ ノ カツ，アタカモ
恵	メグム，チエ ノ エ
恷	キュウ，キュウジツノキュウノシタニココロ
悁	エン，リッシンベンニキヌイトノキヌノツクリ
悃	コン，リッシンベンニコマル
悄	ショウゼンタルスガタノショウ，リッシンベンニショウゾウガノショウ
悉	シッカイ ノ シツ，コトゴトク
悋	シットヲイミスルリンキノリン
悌	テイ，リッシンベン ニ オトウト
悍	セイカンナカオツキノカン
悒	ユウ，リッシンベンニトユウノユウ
悔	コウカイスル ノ カイ，クヤム
悖	ボツ，リッシンベンニボッパツスルノボツノヒダリガワ
悗	バン，リッシンベンニメンキョノメン
悚	ショウ，リッシンベンニタバ
悛	カイシュンノジョウノシュン
悟	サトル，カクゴ ノ ゴ
悠	ユウユウジテキ ノ ユウ
患	カンジャ ノ カン，ワズラウ
悦	エツラク ノ エツ，ヨロコブ
悧	レイリノリ，リッシンベンニケンリノリ
悩	ナヤム，クノウスル ノ ノウ
悪	ゼンアク ノ アク，ワルイ
悲	ヒゲキ ノ ヒ，カナシイ
悳	トク，ドウトクノトクノイタイジ
悴	ショウスイスルノスイ
悵	チョウ，リッシンベンニチョウタンノチョウ
悶	クモンスル ノ モン，モダエル
悸	ドウキガスルノキ
悼	アイトウ ノ トウ，イタム
悽	セイ，リッシンベンニフサイノサイ，ツマ
情	ユウジョウ ノ ジョウ，ナサケ
惆	チュウ，リッシンベンニシュウヘンノシュウ
惇	リッシンベン ニ キョウラクテキ ノ キョウ，トン
惑	メイワク ノ ワク
惓	ケン，リッシンベンニノリマキノマキ
惘	ボウ，リッシンベンニモウマクノモウノツクリ
惚	ホレル，コウコツ ノ コツ
惜	オシム，セキハイ ノ セキ
惟	シイ ノ イ，リッシンベン ニ フルトリ
惠	メグム，チエノエノキュウジ
惡	ゼンアクノアク，ワルイノキュウジ
惣	オソウザイ ノ ソウ
惧	キグスルノグ
惨	ザンパイスル ノ ザン，ミジメ
惰	タイダ ノ ダ
惱	ナヤム，クノウスルノノウノキュウジ
想	カンソウブン ノ ソウ
惴	ズイ，リッシンベンニゼンソクノゼンノツクリ
惶	コウ，リッシンベンニコウタイシノコウ
惷	シュン，キセツノハルノシタニココロ
惹	ジャッキスル ノ ジャク，ヒク
惺	セイ，リッシンベンニホシ
惻	ソクインノジョウノソク，リッシンベンニホウソクノソク
愀	ショウ，リッシンベンニキセツノアキ
愁	アイシュウ ノ シュウ，ウレイ
愃	セン，リッシンベンニセンデンスルノセン
愆	ケン，フエンスルノエンノシタニココロ
愈	ユ，イヨイヨ
愉	ユカイナ ノ ユ
愍	ビン，タミトノブンノシタニココロ
愎	フク，リッシンベンニオウフクノフクノツクリ
意	イミ ノ イ
愕	キョウガクスルノガク
愚	グチ ノ グ，オロカ
愛	アイスル ノ アイ
感	カンソウブン ノ カン
愡	ソウ，リッシンベンニネギノクサカンムリノシタガワ
愧	ザンキニタエナイノキ
愨	マコトヲイミスルカク
愬	ソ，ハッサクノサクノシタニココロ
愴	ヒソウナノソウ，リッシンベンニカマクラバクフノクラ
愼	シンチョウナノシン，ツツシムノキュウジ
愽	ハクブツカンノハクノイタイジ
愾	キ，リッシンベンニクウキノキノキュウジ
愿	ゲン，ノハラノハラノシタニココロ
慂	ヨウ，コワクダニノワクノシタニココロ
慄	センリツスルノリツ
慇	インギンナノイン
慈	ジヒブカイ ノ ジ，イツクシム
慊	ケン，リッシンベンニカネル
態	タイド ノ タイ
慌	アワテル，キョウコウ ノ コウ
慍	ウン，リッシンベンニオンセンノオンノキュウジタイノツクリ
慎	シンチョウナ ノ シン，ツツシム
慓	ヒョウ，リッシンベンニトウヒョウスルノヒョウ
慕	ボジョウ ノ ボ，シタウ
慘	ザンパイスルノザン，ミジメノキュウジ
慙	ザンキニタエナイノザン，シタゴコロ
慚	ザンキニタエナイノザン，リッシンベン
慝	トク，トクメイノトクノシタニココロ
慟	ドウコクスルノドウ
慢	ジマンスル ノ マン
慣	シュウカン ノ カン，ナレル
慥	ソウ，リッシンベンニカイゾウスルノゾウ
慧	ケイガン ノ ケイ，サトイ
慨	カンガイムリョウ ノ ガイ
慫	ショウ，フクジュウスルノジュウノキュウジノシタニココロ
慮	エンリョスル ノ リョ
慯	ショウ，リッシンベンニキリキズノキズ
慰	イシャリョウ ノ イ，ナグサメル
慱	タン，リッシンベンニセンモンノセンノキュウジ
慳	ケン，リッシンベンニケンジツナノケン
慴	ショウ，リッシンベンニレンシュウスルノシュウ，ナラウ
慵	ヨウ，リッシンベンニボンヨウナノヨウ
慶	ケイチョウキュウカ ノ ケイ，ヨロコブ
慷	ヒフンコウガイノコウ，リッシンベンニイエヤスノヤス
慾	ヨクボウ ノ ヨク，シタゴコロアリ
憂	ユウウツ ノ ユウ，ウレウ
憇	キュウケイノケイ，イコウノイタイジ
憊	ヒロウコンパイノハイ
憎	ニクム，ゾウオ ノ ゾウ
憐	カレンナ ノ レン，アワレム
憑	ヒョウイスルノヒョウ，キツネツキノツク
憔	ショウスイスルノショウ
憖	ギン，ライネンノライノキュウジトイヌノシタニココロ
憙	キ，キドアイラクノキノシタニココロ
憚	キタンノナイノタン，ハバカル
憤	フンガイスル ノ フン，イキドオル
憧	ドウケイ ノ ドウ，アコガレル
憩	キュウケイ ノ ケイ，イコウ
憫	レンビンノビン，リッシンベンニモンガマエニブンショウヲカクノブン
憬	ドウケイノマトノケイ，リッシンベンニフウケイノケイ
憮	ブゼントスルノブ
憲	ケンポウキネンビ ノ ケン
憶	キオク ノ オク，オボエル
憺	クシンサンタンノタン，リッシンベンニタンニンノタンノキュウジノツクリ
憾	イカンナク ノ カン
懃	インギンブレイノギン
懆	ソウ，リッシンベンニソウジュウスルノソウノツクリ
懇	コンシンカイ ノ コン，ネンゴロ
懈	ケタイスルノケ，リッシンベンニカイケツスルノカイ
應	オウエンスルノオウノキュウジ
懊	オウノウスルノオウ，ナヤム
懋	ボウ，ハヤシノアイダニムジュンスルノム，ソノシタニココロ
懌	エキ，リッシンベンニサワノキュウジノツクリ
懍	リン，リッシンベンニリンギスルリン
懐	カイチュウデントウ ノ カイ，フトコロ
懣	フンマンヤルカカタナシノマン
懦	キョウダノダ，ヨワイ，リッシンベンニヒツジュヒンノジュ
懲	コラシメル，チョウバツ ノ チョウ
懴	ザンゲスルノザン，クイルノイタイジ
懶	ランダナノラン，リッシンベンニイライスルノライノキュウジ
懷	カイチュウデントウノカイ，フトコロノキュウジ
懸	イッショウケンメイ ノ ケン，カケル
懺	ザンゲスルノザン，クイル
懼	キョウクスルノク，リッシンベンニメガフタツノシタニフルトリ
懽	カン，リッシンベンニカンガイヨウスイノカンノツクリ
懾	ショウ，リッシンベンニミミミッツ
懿	ダイヨンダイイトクテンノウノイ
戀	コイビトノコイノキュウジ
戈	カ，ブシュノホコヅクリ
戉	マサカリ，エツ，カネヘンナシ
戊	ボシンセンソウ ノ ボ
戌	ジュツ，ジュウニシノイヌ
戍	ジュ，マモル，ボシンセンソウノボノナカニテン
戎	エビス，ホコガマエ ノ ジュウ
成	セイチョウスル ノ セイ，ナル
我	ガマン ノ ガ，ワレ
戒	ケイカイスル ノ カイ，イマシメル
戔	サン，アサイノキュウジノツクリ
或	アルイハ ノ アル
戚	トオイシンセキ ノ セキ
戛	カツ，ページノハノカワリニホコヅクリ
戝	サンゾクノゾクノイタイジ
戞	カツ，ユウウツノユウノウエガワニホコヅクリ
戟	シゲキスル ノ ゲキ，ホコ
戡	カン，ハナハダシイノミギニホコヅクリ
戦	センソウ ノ セン，タタカウ
截	セツゼンタルノセツ，サイバイスルノサイノキノカワリニフルトリ
戮	サツリクスルノリク
戯	ギキョク ノ ギ
戰	センソウノセン，タタカウノキュウジ
戲	ギキョクノギノキュウジ
戳	タク，センタクモノノタクノツクリニホコヅクリ
戴	タイカンシキ ノ タイ，イタダク
戸	トジマリ ノ ト，コ
戻	モドル，ヘンレイキン ノ レイ
房	レイダンボウ ノ ボウ
所	ジュウショ ノ ショ，トコロ
扁	ヘン，ヘンシュウスル，アムノツクリ
扇	センプウキ ノ セン，オウギ
扈	チョウリョウバッコノコ
扉	トビラ，モンピ ノ ヒ
手	テアシ ノ テ，シュ
才	サイノウ ノ サイ
扎	サツ，テヘンニレイギノレイノツクリ
打	タゲキ ノ ダ，ウツ
払	カネヲハラウ ノ ハラウ
托	タクハツ ノ タク
扛	コウ，テヘンニズガコウサクノコウ
扞	カン，テヘンニホス
扠	サ，テヘンニヤシャノシャ
扣	コウ，テヘンニクチ
扨	サテ，テヘンニヤイバノイタイジ
扮	フンソウヲコラス ノ フン
扱	アツカウ
扶	フヨウカゾク ノ フ
批	ヒハンスル ノ ヒ
扼	セッシヤクワンノヤク
找	カ，テヘンニホコヅクリ
承	ショウダクスル ノ ショウ
技	ギジュツ ノ ギ，ワザ
抂	キョウ，テヘンニオウサマノオウ
抃	ベンブスルノベン，テヘンニナベブタノシタニカタカナノト
抄	コセキショウホン ノ ショウ
抉	ケツ，テヘンニタスウケツノケツノツクリ
把	ハアクスル ノ ハ
抑	ヨクセイスル ノ ヨク，オサエル
抒	ジョジョウシノジョ，テヘンニヨテイノヨ
抓	ソウ，ツネル，テヘンニツメ
抔	ホウ，テヘンニフシギノフ
投	トウシュ ノ トウ，ナゲル
抖	トウ，テヘンニホクトシチセイノト
抗	テイコウスル ノ コウ
折	コッセツ ノ セツ，オル
抛	ホウテキスルノホウ，テヘンニカンスウジノキュウニチカラ
抜	バツグン ノ バツ，ヌケル
択	センタクシ ノ タク
披	ヒロウエン ノ ヒ
抬	タイ，テヘンニダイドコロノダイ
抱	ホウフヲカタル ノ ホウ，ダク
抵	テイコウスル ノ テイ
抹	マッチャ ノ マツ
抻	シン，テヘンニシンコクスルノシン
押	オウシュウスル ノ オウ，オス
抽	チュウセン ノ チュウ
拂	カネヲハラウノハラウノキュウジ
担	タンニン ノ タン
拆	タク，テヘンニハイセキウンドウノセキ
拇	ボインヲオスノボ
拈	ネン，テヘンニドクセンスルノセン
拉	ラチスルノラ
拊	フ，テヘンニフロクノフ
拌	カクハンスルノハン，カキマゼル
拍	ハクシュスル ノ ハク
拏	ダホスルノダ，ヤッコノシタニテ
拐	ユウカイジケン ノ カイ
拑	カン，テヘンニアマイ
拒	キョヒスル ノ キョ，コバム
拓	カイタクスル ノ タク
拔	バツグンノバツ，ヌケルノキュウジ
拗	ヨウオンノヨウ，テヘンニオオサナイ
拘	コウソクジカン ノ コウ
拙	チセツ ノ セツ，ツタナイ
招	マネク，ショウタイスル ノ ショウ
拜	オガムノキュウジ
拝	オガム，ハイケイ ノ ハイ
拠	キョテン ノ キョ
拡	カクダイ ノ カク
括	ソウカツ ノ カツ，ククル
拭	フッショク ノ ショク，ヌグウ
拮	キッコウスルノキツ
拯	ジョウ，テヘンニダイジンヲイミスルジョウショウノジョウ
拱	コマヌク，キョウ，テヘンノキョウツウノキョウ
拳	ケンジュウ ノ ケン，コブシ
拵	コシラエル，ソン
拶	アイサツ ノ サツ
拷	ゴウモンスル ノ ゴウ
拾	オカネヲ ヒロウ ノ ヒロウ
拿	ダホスルノダ，ゴウカクノゴウノシタニテ
持	ジゾクスル ノ ジ，モツ
挂	ケイ，テヘンニツチフタツ
指	シドウスル ノ シ，ユビ
挈	ケツ，ケイヤクスルノケイノダイノカワリニテ
按	アンマ ノ アン
挌	カク，テヘンニカクジノカク
挑	チョウセンスル ノ チョウ，イドム
挙	センキョ ノ キョ，アゲル
挟	ハサム，キョウ
挧	ウ，テヘンニウモウノウ
挨	アイサツスル ノ アイ
挫	ネンザ ノ ザ，クジク
振	サンシンスル ノ シン，フル
挺	クウテイブタイ ノ テイ
挽	バンカイスル ノ バン
挾	ハサム，キョウノキュウジ
挿	ソウニュウスル ノ ソウ，サス
捉	トラエル，テヘン ニ アシ
捌	ウリサバク ノ サバク，テヘン ニ ワカレル
捍	カン，テヘンニヒデリヲイミスルカンバツノカン
捏	ネツゾウスルノネツ，コネル
捐	ギエンキンノエン，テヘンニキヌイトノキヌノツクリ
捕	タイホスル ノ ホ，トラエル
捗	シンチョクジョウキョウ ノ チョク，ハカドル
捜	ソウサジョウ ノ ソウ，サガス
捧	ササゲル，ホウ
捨	シシャゴニュウ ノ シャ，ステル
捩	レイ，ネジル，テヘンニモドル
捫	モン，テヘンニセンモンノモン
据	スエル，スエオキ ノ スエ
捲	マクル，ケンドジュウライ ノ ケン
捶	スイ，テヘンニスイチョクノスイ
捷	ビンショウナ ノ ショウ
捺	ナツインスル ノ ナツ
捻	ネンザ ノ ネン，ヒネル
掀	キン，テヘンニキンキジャクヤクノキン
掃	ソウジスル ノ ソウ，ハク
授	ジュギョウ ノ ジュ，サズケル
掉	チョウ，テヘンニタッキュウノタク
掌	ショウアクスル ノ ショウ，テノヒラ
掎	キ，テヘンニキミョウナノキ
掏	トウ，テヘンニトウゲイカノトウノツクリ
排	ハイジョスル ノ ハイ
掖	エキ，テヘンニヒルヨルノヨル
掘	ホル，ハックツ ノ クツ
掛	カケブトン ノ カケ
掟	オキテ，テヘンニサダメル
掠	カスメル，リャクダツ ノ リャク
採	サイヨウ ノ サイ，トル
探	タンケン ノ タン，サガス
掣	セイ，セイゲンスルノセイノシタニテ
接	セツゾクスル ノ セツ
控	コウジョスル ノ コウ，ヒカエル
推	スイセンスル ノ スイ，オス
掩	エンゴシャゲキ ノ エン
措	ソチスル ノ ソ
掫	ソウ，テヘンニシュザイスルノシュ
掬	スクイナゲ ノ スクウ
掲	ケイジバン ノ ケイ，カカゲル
掴	ツカム，テヘン ニ クニ
掵	ハバ，テヘンニイノチ
掻	ヒッカク ノ カク，カッカソウヨウ ノ ソウ
掾	エン，テヘンニエンガワノエンノキュウジノツクリ
揀	カン，テヘンニサカナノニシンノツクリ
揃	ソロエル
揄	ヤユスルノユ
揆	ヒャクショウイッキノキ
揉	モム，テヘンニジュウドウノジュウ
描	エガク，ビョウシャスル ノ ビョウ
提	テイアン ノ テイ
插	ソウニュウスルノソウ，サスノキュウジ
揖	イチユウ ノ ユウ，テヘン ニ クチ ノ シタニ ミミ
揚	アゲル，カラアゲ
換	カンキセン ノ カン，カエル
握	アクリョク ノ アク，ニギル
揣	シマオクソクノシ，テヘンニタンマツノタンノツクリ
揩	カイ，テヘンニミナサマノミナ
揮	シキスル ノ キ
援	オウエンスル ノ エン
揶	ヤユスルノヤ
揺	ユレル，ドウヨウスル ノ ヨウ
搆	コウ，テヘンニミゾノツクリ
損	ソンガイ ノ ソン
搏	ミャクハクノハク，テヘンニハクブツカンノハクノツクリ
搓	サ，テヘンニサベツカスルノサ
搖	ユレル，ドウヨウスルノヨウノキュウジ
搗	モチツキノツキ
搜	ソウサジョウノソウ，サガスノキュウジ
搦	カラメテノカラメ，テヘンニキョウジャクノジャク
搨	トウ，テヘンニニチヨウビノニチノシタニハネ
搬	ハンニュウスル ノ ハン
搭	トウジョウテツヅキ ノ トウ
搴	ケン，サムイノシタニテンノカワリニテ
搶	ソウ，テヘンニカマクラバクフノクラ
携	ケイタイ ノ ケイ，タズサエル
搾	サクシュ ノ サク，シボル
摂	セッセイスル ノ セイ，トル
摎	コウ，テヘンニニカワノツクリ
摘	テキハツスル ノ テキ，ツム
摧	サイ，テヘンニモヨオシノツクリ
摩	マサツ ノ マ
摯	シンシナタイドノシ，シツジノシツノシタニテ
摶	タン，テヘンニセンモンノセンノキュウジ
摸	モシャスル ノ モ，テヘン
摺	テスリアシスリ ノ スリ
撃	コウゲキ ノ ゲキ，ウツ
撈	ギョロウノロウ，テヘンニロウドウノロウノキュウジ
撒	ミズヲマク ノ マク，サン
撓	フトウフクツノトウ，タワム
撕	シ，テヘンニシカイノケンイノシ
撚	ヒネル，テヘン ニ シゼン ノ ゼン
撞	ジカドウチャク ノ ドウ，ツク
撤	テッタイスル ノ テツ
撥	ハネル，ハツ，テヘンニハツメイノハツノキュウジ
撩	リョウランノリョウ，テヘンニドウリョウノリョウノツクリ
撫	アイブスル ノ ブ，ナデル
播	デンパスル ノ ハ，マク
撮	サツエイスル ノ サツ，トル
撰	チョクセンワカシュウ ノ セン，エラブ
撲	ダボク ノ ボク
撹	カクランスル ノ カク
撻	ベンタツスルノタツ
撼	シンカンサセルノカン，テヘンニカンソウブンノカン
擁	ヨウリツスル ノ ヨウ
擂	ライ，テヘンニカミナリ
擅	ドクセンジョウノセン，テヘンニダンカノダンノツクリ
擇	センタクシノタクノキュウジ
操	ソウジュウスル ノ ソウ，アヤツル
擒	キン，テヘンニモウキンルイノキン
擔	タンニンノタンノキュウジ
擘	ヘキ，カベノツチノカワリニテ
據	キョテンノキョノキュウジ
擠	セイ，テヘンニヘソノツクリ
擡	タイトウスルノタイ，テヘンニダイドコロノダイノキュウジ
擢	バッテキスル ノ テキ
擣	トウ，テヘンニコトブキノキュウジ
擦	マサツ ノ サツ，スル
擧	センキョノキョ，アゲルノキュウジ
擬	モギテン ノ ギ
擯	ヒン，テヘンニライヒンノヒン
擱	カクザスルノカク，テヘンニテンシュカクノカク
擲	トウテキキョウギノテキ，ナゲウツ
擴	カクダイスルノカクノキュウジ
擶	セン，テヘンニタケカンムリニマエ
擺	ハイ，テヘンニヒメンスルノヒ
擽	リャク，テヘンニオンガクノガクノキュウジ
擾	ジョウラン ノ ジョウ，テヘン ニ ユウウツ ノ ユウ
攀	ガンペキヲトウハンスルノハン
攅	サン，アツメル，テヘンニサンセイスルノサン
攘	ソンノウジョウイノジョウ，ハラウ
攜	ケイタイスルノケイ，タズサエルノイタイジ
攝	セッセイスルノセイ，トルノキュウジ
攣	ケイレンヲオコスノレン
攤	タン，テヘンニコンナンナノナンノキュウジ
攪	コウランスルノコウ，ミダス
攫	イッカクセンキンノカク，ツカム
攬	ラン，テヘンニハクランカイノランノキュウジ
支	シエンスル ノ シ，ササエル
攴	ボク，ブシュノトマタ
攵	ボク，ブシュノノブン，ハイボクスルノハイノツクリ
收	シュウニュウノシュウノキュウジ
攷	コウ，ギコウテキナノコウノツクリノミギニノブン
攸	ユウ，ニンベンニタテボウニノブン
改	カイリョウ ノ カイ，アラタメル
攻	コウゲキ ノ コウ，セメル
放	ホウソウキョク ノ ホウ，ハナツ
政	セイジカ ノ セイ
故	コキョウ ノ コ，ユエ
效	コウカテキナノコウノキュウジ
敍	ジジョデンノジョノキュウジ
敏	ビンカンナ ノ ビン
救	キュウジョ ノ キュウ，スクウ
敕	チョクメイノチョクノキュウジ
敖	ゴウ，ゴウマンナノゴウノツクリ
敗	ハイボク ノ ハイ，ヤブレル
敘	ジジョデンノジョノイタイジ
教	キョウカショ ノ キョウ，オシエル
敝	ヘイイハボウノヘイ，ニジュウアシナシ
敞	カイグンコウショウノショウタレナシ
敢	ユウカンナ ノ カン，アエテ
散	サンポ ノ サン，チル
敦	チュウゴク ノ トンコウ ノ トン
敬	ソンケイ ノ ケイ，ウヤマウ
数	サンスウ ノ スウ，カズ
敲	スイコウヲカサネルノコウ，タタク
整	セイリスル ノ セイ，トトノエル
敵	テキミカタ ノ テキ
敷	シク，ザシキ ノ シキ
數	サンスウノスウノキュウジ
斂	イッテンニシュウレンスルノレン
斃	ノタレジニヲイミスルヘイシノヘイ
文	サクブン ノ ブン
斈	マナブ，ガクシュウノガクノイタイジ
斉	イッセイシャゲキ ノ セイ
斌	ヒン，ブンブリョウドウ ノ ブント ブ
斎	ショサイニコモル ノ サイ
斐	ヒ，カイノクニ ノ ニモジメ
斑	マダラ，ハンテン ノ ハン
斗	ホクトシチセイ ノ ト
料	リョウリスル ノ リョウ
斛	ヨウリョウノタンイノコク，ツノヘンニタンイノト
斜	ナナメ，シャメン ノ シャ
斟	シンシャクスルノシン，クム
斡	アッセンスル ノ アツ
斤	ショクパンイッキン ノ キン
斥	ハイセキスル ノ セキ，シリゾケル
斧	ドウグ ノ オノ
斫	シャク，イシヘンニパンイッキンノキン
斬	ザンシンナ ノ ザン，キル
断	ハンダン ノ ダン
斯	シカイ ノ ケンイ ノ シ，カク
新	アタラシイ，シンブン ノ シン
斷	ダンネンスルノダンノキュウジ
方	オヤカタ ノ カタ，ホウガク ノ ホウ
於	ナニナニニオイテ ノ オ
施	シセツ ノ シ，ホドコス
旁	ホウ，カンジノブシュノツクリ
旃	セン，ホウヘンニセンダンノキノセンノツクリ
旄	ケデツクッタハタカザリノボウ
旅	リョコウ ノ リョ，タビ
旆	オオキナハタヲイミスルタイハイノハイ
旋	センカイスル ノ セン
旌	ハタジルシヲイミスルセイ
族	スイゾクカン ノ ゾク
旒	ハタヲカゾエルタンイノリュウ
旗	コッキ ノ キ，ハタ
旙	ハタガヒルガエルサマノハンノイタイジ
旛	ハタガヒルガエルサマノハン
无	ム，ナイ，テンキヨホウノテンノヨンカクメヲオツニスル
旡	キ，ツマル，キトクケンノキ，スデニノツクリ
既	キトクケン ノ キ，スデニ
日	ニチヨウビ ノ ニチ，ヒ
旦	ガンタン ノ タン
旧	キュウレキ ノ キュウ
旨	ロンシヲ ノベル ノ シ，ムネ
早	ソウチョウ ノ ソウ，ハヤイ
旬	ゲジュン ノ ジュン
旭	キョクジツ ノ キョク，アサヒ
旱	カンバツノカン，ヒデリ
旺	ショクヨクオウセイナ ノ オウ
旻	ビン，アキゾラ，ニチヨウビノニチノシタニサクブンノブン
昂	ゲキコウスル ノ コウ
昃	ソク，ニチヨウビノニチノシタニソクブンスルノソク
昆	コンチュウ ノ コン
昇	ショウカクスル ノ ショウ，ノボル
昊	コウ，ニチヨウビノニチノシタニテンキヨホウノテン
昌	ショウ，ニチ ノ シタニ ニチ
明	セツメイ ノ メイ，アカルイ
昏	コンスイスル ノ コン
易	ボウエキ ノ エキ，ヤサシイ
昔	ムカシバナシ ノ ムカシ
昜	ヨウ，タイヨウケイノヨウノツクリ
星	ホシ，セイザ ノ セイ
映	エイガ ノ エイ，ウツス
春	ハルヤスミ ノ ハル，シュン
昧	アイマイナ ノ マイ
昨	サクネン ノ サク
昭	ショウワウマレ ノ ショウ
是	ゼヒ ノ ゼ
昴	スバル
昵	ジッコンノアイダガラノジツ，ニチヘンニアマデラノアマ
昶	チョウ，エイキュウノエイノミギニニチヨウビノニチ
昼	ヒルヤスミ ノ ヒル，チュウ
昿	コウ，ニチヘンニヒロイ
晁	チョウ，ニチヨウビノニチノシタニイッチョウエンノチョウ
時	ジカン ノ ジ，トキ
晃	ニチヨウビ ノ ニチ ノ シタニ ヒカリ，アキラ
晄	コウ，ニチヘンニヒカリ
晉	チュウゴクノコクメイノシン，ススムノキュウジ
晋	チュウゴク ノ コクメイ ノ シン，ススム
晏	アン，ニチヨウビノニチノシタニアンシンノアン
晒	サラシモメン ノ サラシ
晝	ヒルヤスミノヒル，チュウノキュウジ
晞	キ，ニチヘンニキボウノキ
晟	セイ，ニチヨウビノニチノシタニセイチョウスルノセイ
晢	セツ，コッセツスルノセツノシタニニチヨウビノニチ
晤	ゴ，ニチヘンニタゴサクノゴ
晦	ミソカ，ニチヘン ニ マイ
晧	コウ，ヒヘンニツゲル
晨	シン，ニチヨウビノニチノシタニジュウニシノタツ
晩	バンゴハン ノ バン
普	フキュウスル ノ フ
景	フウケイ ノ ケイ
晰	ズノウメイセキノセキ
晴	ハレ，セイテン ノ セイ
晶	スイショウダマ ノ ショウ
智	チ，シル ノ シタニ ニチヨウビ ノ ニチ
暁	アカツキ
暃	ニチヨウビノニチノシタニヒジョウグチノヒ
暄	ケン，ニチヘンニセンデンノセン
暇	キュウカ ノ カ，ヒマ
暈	メマイヲイミスルゲンウンノウン
暉	キ，ニチヘンニグンタイノグン
暎	エイ，ニチヘンニエイユウノエイ
暑	アツイサムイ ノ アツイ，ショ
暖	ダンボウ ノ ダン，アタタカイ
暗	アンキスル ノ アン，クライ
暘	ヨウ，ニチヘンニタイヨウケイノヨウノツクリ
暝	メイ，ニチヘンニメイフクヲイノルノメイ
暢	リュウチョウナ ノ チョウ
暦	セイレキ ノ レキ，コヨミ
暫	ザンテイテキ ノ ザン，シバラク
暮	オセイボ ノ ボ，クラス
暴	ボウリョク ノ ボウ，アバレル
暸	リョウ，メイリョウナノリョウノメノカワリニヨウビノニチ
暹	セン，シンポノシンノウエニニチヨウビノニチ
暼	ヘツ，イチベツスルノベツノメノカワリニヨウビノニチ
暾	トン，ニチヘンニチュウゴクノトンコウノトン
曁	キ，キトクケンノキノシタニガンタンノタン
曄	ヨウ，ニチヘンニチュウカナベノカ
曇	クモリ，ドンテン ノ ドン
曉	アカツキノキュウジ
曖	アイマイナノアイ
曙	アケボノ，ショ
曚	ボウ，ニチヘンニケイモウスルノモウ
曜	ニチヨウビ ノ ヨウ
曝	サラス，ニチヘン ニ ボウリョク ノ ボウ
曠	コウヤノコウ，ニチヘンニヒロイノキュウジ
曦	ギ，ウツクシイタイヨウヲイミスルニチヘンノギ
曩	ノウ，ヨウビノニチノシタニユズルノキュウジノツクリ
曰	イワクツキノイワク
曲	キョクセン ノ キョク，マガル
曳	エイコウスル ノ エイ，ヒク
更	ヘンコウ ノ コウ，サラニ
曵	フネヲエイコウスルノエイノイタイジ
曷	カツ、カッショクノカツノツクリ
書	キョウカショ ノ ショ，カク
曹	ソウトウシュウ ノ ソウ
曼	マンダラノマン
曽	キソジ ノ ソ
曾	キソジ ノ ソ ノ キュウジ
替	フリカエコウザ ノ カエル
最	サイショ ノ サイ，モットモ
會	カイシャノカイ，アウノキュウジ
月	ゲツヨウビ ノ ゲツ，ツキ
有	ユウメイジン ノ ユウ，アル
朋	ホウユウ ノ ホウ，トモ
服	ヨウフク ノ フク
朏	ヒ、ミカヅキ、ツキヘンニデル
朔	サクジツ ノ サク，ツイタチ
朕	チンオモウニ ノ チン
朖	ロウドクノロウノイタイジ、ツキヘンニカイリョウスルノリョウ
朗	ロウドク ノ ロウ
望	キボウ ノ ボウ，ノゾム
朝	アサヒ ノ アサ，チョウ
朞	キ、キホンノキノツチノカワリニツキ
期	キタイスル ノ キ
朦	モウロウトスルノモウ
朧	モウロウトスルノロウ
木	モクヨウビ ノ モク，キ
未	ミライ ノ ミ
末	ネンマツ ノ マツ，スエ
本	ホンモノ ノ ホン，モト
札	ナフダ ノ フダ，サツ
朮	ジュツ、ジュツゴノジュツノツクリ
朱	シュイロ ノ シュ
朴	ソボクナ ノ ボク
朶	ミミタブヲイミスルジダノダ
朷	トウ、キヘンニカタナ
朸	ロク、キヘンニチカラ
机	ツクエ
朽	ロウキュウカスル ノ キュウ，クチル
朿	シ、トゲ、シゲキスルノシノヒダリガワ
杁	イリ、キヘンニハイル
杆	カン、キヘンニホス
杉	スギノキ ノ スギ
李	リカニ カンムリヲ タダサズ ノ リ，スモモ
杏	アンズ，キョウリン ノ キョウ
材	ザイリョウ ノ ザイ
村	ムラ，シチョウソン ノ ソン
杓	シャクシジョウギ ノ シャク
杖	ハクジョウ ノ ジョウ，ツエ
杙	ヨク、キヘンニダイヒョウノダイノツクリ
杜	モリ，キヘン ニ ツチ
杞	キユウニオワルノキ
束	ヤクソク ノ ソク
杠	コウ、キヘンニズガコウサクノコウ
条	ジョウケン ノ ジョウ
杢	モク，キ ノ シタニ コウ
杣	ソマ、キヘンニヤマ
杤	トチギケンノトチノイタイジ、キヘンニマンネンヒツノマン
来	ライネン ノ ライ，クル
杪	ビョウ、コズエ、キヘンニスクナイ
杭	クイヲウツ ノ クイ
杯	カンパイ ノ ハイ，サカズキ
杰	ゴウケツノケツノイタイジ，モクザイノモクノシタニレンガ
東	トウザイ ノ トウ，ヒガシ
杲	コウ，アキラカ，ニチヨウビノニチノシタニジュモクノモク
杳	ヨウトシテシレナイノヨウ，ヨウビノモクノシタニニチ
杵	ウスキネ ノ キネ
杷	ショクブツ ノ ビワ ノ ハ，キヘン ニ トモエ
杼	ジョ、キヘンニヨテイノヨ
松	マツノキ ノ マツ，ショウ
板	コクバン ノ バン，イタ
枅	ケイ，キヘンニセイホウケイノケイノヒダリガワ
枇	ショクブツ ノ ビワ ノ ビ，キヘン ニ クラベル
枉	オウ、マガル、キヘンニオウサマノオウ
枋	ホウ、キヘンニセイホウケイノホウ
枌	フン、キヘンニハンブンノブン
析	ブンセキスル ノ セキ
枕	マクラ
林	シンリン ノ リン，ハヤシ
枚	マイスウ ノ マイ
果	ケッカ ノ カ，ハタス
枝	キノエダ ノ エダ
枠	ソトワク ノ ワク
枡	マス、キヘンニイッショウビンノショウ
枢	チュウスウ ノ スウ
枦	ハゼノキノハゼノイタイジ，キヘンニトジマリノト
枩	マツノキノマツノイタイジ
枯	カレル，コカツスル ノ コ
枳	カラタチ，キヘンニタダイマノタダ
枴	カイ，キヘンニユウカイハンノカイノツクリ
架	ジュウジカ ノ カ，カケル
枷	カ，キヘンニカソクドノカ
枸	ク，キヘンニハイクノク
枹	フ，キヘンニヒョウガフルノヒョウノシタガワ
柁	カジ，キヘン ニ ウカンムリ ニ カタカナ ノ ヒ
柄	ヒトガラ ノ ガラ
柆	ロウ，キヘンニドクリツノリツ
柊	ショクブツ ノ ヒイラギ，キヘン ニ フユ
柎	フ，キヘンニフロクノフ
柏	カシワモチ ノ カシワ
某	ナニガシ ノ ボウ
柑	カンキツルイ ノ カン
染	センショク ノ セン，ソメル
柔	ジュウドウ ノ ジュウ，ヤワラカイ
柘	ザクロ ノ イチモジメ，キヘン ニ イシ
柚	ショクブツ ノ ユズ，ユウ
柝	タク，キヘンニハイセキウンドウノセキ
柞	サク，キヘンニサクブンノサクノツクリ
柢	テイ，キヘンニヒクイノツクリ
柤	サ，キヘンニナオカツノカツ
柧	コ，キヘンニウリ
柩	ヒツギ，レイキュウシャノキュウ
柬	カン，イサメルノツクリ
柮	トツ，キヘンニガイシュツスルノトツ
柯	カ，キヘンニカノウセイノカ
柱	ハシラ，チュウ
柳	ヤナギ，センリュウ ノ リュウ
柴	シバイヌ ノ シバ，タキギ ノ シバ
柵	サクデカコム ノ サク
査	ケンサ ノ サ
柾	ショクブツ ノ マサキ，キヘン ニ タダシイ
柿	クダモノ ノ カキ
栂	ショクブツ ノ ツガ，キヘン ニ ハハ
栃	トチギケン ノ トチ
栄	エイヨウ ノ エイ，サカエル
栓	センヌキ ノ セン
栖	スム，セイ，キヘン ニ ニシ
栗	クリノキ ノ クリ
栞	シオリヲハサムノシオリ
校	ガッコウ ノ コウ
栢	カヤ，キヘン ニ ヒャク
栩	ク，キヘンニウモウノウ
株	カブシキ ノ カブ
栫	ソン，キヘンニソンザイスルノソン
栲	コウ，キヘンニサンコウショノコウ
栴	ショクブツ ノ センダン ノ セン
核	カクカゾク ノ カク
根	ダイコン ノ コン，ネ
格	ゴウカク ノ カク
栽	サイバイスル ノ サイ
桀	ケツ，ゴウケツノケツノツクリ
桁	ケタハズレ ノ ケタ
桂	ゲッケイジュ ノ ケイ，カツラ
桃	モモタロウ ノ モモ
框	アガリカマチノカマチ
案	アンナイ ノ アイ
桍	コ，キヘンニハカマノツクリ
桎	シッコクトナルノシツ，アシカセ，キヘンニゲシノシ
桐	キリ ノ タンス ノ キリ
桑	クワノキ ノ クワ，ソウ
桓	カンムテンノウ ノ カン
桔	キヘン ニ キチ，キキョウ ノ イチモジメ
桙	ウ，ホコ，キヘンニシャカムニノム
桜	サクラ
桝	キヘン ノ マス ノ イタイジ
桟	サンバシ ノ サン
档	トウ，キヘンニベントウノトウ
桧	ショクブツ ノ ヒノキ，キヘン ニ カイシャ ノ カイ
桴	フ，キヘンニツメノシタニコドモノコ
桶	オケ，フロオケ ノ オケ
桷	カク，キヘンニツノ
桾	クン，キヘンニショクンノクン
桿	カン、キヘンニホスノイタイジ
梁	リョウザンパク ノ リョウ，ハリ
梃	テコイレノテコ，テイ
梅	ウメボシ ノ ウメ
梍	ソウ，キヘンニシロクロノシロニカンスウジノナナ
梏	シッコクトナルノコク，テカセ
梓	アズサ，ジョウシスル ノ シ
梔	ショクブツノクチナシ
梗	ノウコウソク ノ コウ
梛	ダ，キヘンニワカダンナノナ
條	ジョウケンノジョウノキュウジ
梟	フクロウ
梠	リョ，キヘンニオフロノロ
梢	マッショウシンケイ ノ ショウ，コズエ
梦	ユメ，ムチュウノムノイタイジ
梧	ゴ，キヘン ニ ワレ，アオギリ
梨	クダモノ ノ ナシ
梭	サ，キヘンニシュンビンサノシュンノツクリ
梯	ハシゴ，キヘン ニ オトウト
械	キカイテキ ノ カイ
梱	コンポウスル ノ コン
梳	ソ，クシケズル，キヘンニナガレルノツクリ
梵	ボンジノボン
梶	カジノキ ノ カジ，キヘン ニ オ
梹	ショクブツノビンロウジュノビンノイタイジ，キヘンニヘイタイノヘイ
梺	フモト，ハヤシノシタニウエシタノシタ
梼	トウ，キヘン ニ コトブキ
棄	ハキスル ノ キ，ステル
棆	リン，キヘンニリンリテキナノリン
棉	ショクブツ ノ ワタ，キヘン
棊	キ，ショウギヲサスノギノイタイジ
棋	キ，ショウギ ノ ギ
棍	コンボウノコン，キヘンニコンチュウノコン
棒	テツボウ ノ ボウ
棔	コン，キヘンニコンスイジョウタイノコン
棕	シュロノキノシュ
棗	ショクブツノナツメ
棘	トゲ，キョクヒドウブツノキョク
棚	タナオロシ ノ タナ
棟	ビョウトウ ノ トウ，ムネ
棠	トウ，コッカイギジドウノドウノツチノカワリニモクザイノモク
棡	コウ，キヘンニオカヤマケンノオカ
棣	テイ，キヘンニレイヅクリ
棧	サンバシノサンノキュウジ
森	シンリン ノ シン，モリ
棯	ジン，キヘンニザンネンノネン
棲	ドウセイスル ノ セイ，スム
棹	トウ，サオ，キヘンニタッキュウノタク
棺	カンオケ ノ カン，ヒツギ
椀	キヘン ノ シルワン ノ ワン
椁	カク，キヘンニキョウラクテキナノキョウ
椄	ショウ，キヘンニメカケ
椅	イス ノ イ
椈	キク，キヘンニキクノハナノキクノクサカンムリナシ
椋	ムクドリ ノ ムク，キヘン ニ キョウト ノ キョウ
椌	コウ，キヘンニクウキノクウ
植	ショクブツ ノ ショク，ウエル
椎	セキツイ ノ ツイ，シイ
椏	ア，キヘンニアネッタイノアノキュウジ
椒	サンショウウオノショウ
椙	スギ，キヘン ニ ニチガ フタツ
椚	ショクブツノクヌギ，キヘンニセンモンノモン
椛	カバ，キヘン ニ ハナ
検	ケンサ ノ ケン
椡	ショクブツノクヌギ，キヘンニトウチャクノトウ
椢	カイ，キヘンニコクゴノコク
椣	ショクブツノシデ，キヘンニコクゴジテンノテン
椥	チ，キヘンニチシキノチ
椦	ケン，キヘンニジョウシャケンノケンノカタナノカワリニチカラ
椨	タブノキ，キヘンニトドウフケンノフ
椪	ショクブツノポンカンノポン，キヘンニナラブ
椰	ヤシノキノヤ
椴	トドマツ ノ トド，キヘン ニ シュダン ノ ダン
椶	シュロノキノシュノイタイジ
椹	チン，キヘンニハナハダシイ
椽	テン，キヘンニエンガワノエンノキュウジタイノツクリ
椿	ショクブツ ノ ツバキ，キヘン ニ ハル
楊	ツマヨウジ ノ ヨウ，ヤナギ
楓	ショクブツ ノ カエデ，キヘン ニ カゼ
楔	クサビガタモジノクサビ，セツ
楕	ダエンケイ ノ ダ
楙	ボウ，ハヤシノアイダニムジュンノム
楚	シメンソカ ノ ソ
楜	コ，キヘンニクロコショウノコ
楝	レン，キヘンニイサメルノツクリ
楞	ロウ，キヘンニアミガシラニオヤカタノカタ
楠	クスノキ ノ クス，キヘン ニ ミナミ
楡	ニレノキノニレ
楢	ナラノキ ノ ナラ
楪	チョウ，キヘンニシャベルノツクリ
楫	シュウ，キヘンニクチノシタニミミ
業	ジュギョウ ノ ギョウ
楮	ショクブツノコウゾ
楯	キヘン ニ ムジュン ノ ジュン，タテ
楳	キヘン ニ ナニガシ ノ ボウ，ウメ
楴	テイ，キヘンニテイオウノテイ
極	ホッキョク ノ キョク
楷	カイショタイノカイ
楸	シュウ，キヘンニキセツノアキ
楹	エイ，キヘンニミチル，エイ
楼	マテンロウ ノ ロウ
楽	オンガク ノ ガク，タノシイ
楾	ハンゾウ，キヘンニイズミ
榁	ムロノキノムロ，キヘンニムロマチノムロ
概	ガイネン ノ ガイ，オオムネ
榊	ショクブツ ノ サカキ，キヘン ニ カミサマ ノ カミ
榎	エノキ，キヘン ニ ナツ
榑	フ，キヘンニハクブツカンノハクノキュウジノツクリ
榔	ショクブツ ノ ビンロウジュ ノ ロウ
榕	ヨウ，キヘンニヨウセキノヨウ
榛	ショクブツ ノ ハシバミ
榜	ヒョウボウスルノボウ
榠	メイ，キヘンニメイフクヲイノルノメイ
榧	カヤノキノカヤ
榮	エイヨウノエイ，サカエルノキュウジ
榱	スイ，キヘンニオトロエル
榲	オツ，キヘンニオンセンノオンノキュウジタイノツクリ
榴	リュウ，ザクロ，キヘンニリュウガクスルノリュウ
榻	トウ，キヘンニヨウビノニチノシタニハネ
榾	コツ，キヘンニホネ
榿	キ，キヘンニヨロイノツクリ
槁	コウ，キヘンニタカイヒクイノタカイ
槃	ネハンノハン
槇	ショクブツノマキノキュウジ
槊	サク，ハッサクノサクノシタニモクザイノモク
構	コウゾウ ノ コウ，カマエル
槌	テッツイ ノ ツイ，ツチ
槍	ヤリナゲ ノ ヤリ
槎	サ，キヘンニサベツカスルノサ
槐	カイ，ショクブツノエンジュ
槓	コウ，キヘンニミツグ
様	カミサマ ノ サマ，ヨウ
槙	ショクブツ ノ マキ，キヘン ニ マゴコロ ノ マ
槝	カシノキノカシ，キヘンニシマグニノシマ
槞	ロウ，キヘンニキョウリュウノリュウ
槧	ザン，ザンシンナノザンノシタニモクザイノモク
槨	カク，キヘンニリンカクノカク
槫	セン，キヘンニセンモンノセンノキュウジ
槭	シュク，キヘンニトオイシンセキノセキ
槲	コク，キヘンニツノニホクトシチセイノト
槹	コウ，キヘンニサツキノイチモジメ
槻	ショクブツ ノ ツキ，キヘン ニ キソクテキ ノ キ
槽	ヨクソウ ノ ソウ
槿	キン，ショクブツノムクゲ
樂	オンガクノガク，タノシイノキュウジ
樅	モミノキノモキ
樊	トリカゴノイミノハンロウノハン
樋	ヒグチイチヨウ ノ ヒ，トイ
樌	カン，キヘンニイッカンスルノカン
樒	ミツ，キヘンニヒミツノミツ
樓	マテンロウノロウノキュウジ
樔	ソウ，キヘンニハチノスノス
樗	ショクブツ ノ オウチ，チョ
標	モクヒョウ ノ ヒョウ
樛	キュウ，キヘンニニカワノツクリ
樞	チュウスウノスウノキュウジ
樟	ショウノウ ノ ショウ，クス
模	モケイ ノ モ
樢	チョウ，キヘンニヤキトリノトリ
樣	カミサマノサマ，ヨウノキュウジ
権	ケンリ ノ ケン
横	タテヨコ ノ ヨコ，オウ
樫	カシノキ ノ カシ
樮	ホクソ，キヘンニニシノシタニカヨウビノカ
樵	キコリ
樶	サイ，キヘンニサイダイサイショウノサイ
樸	ボク，キヘンニイチニンショウノボクノツクリ
樹	ジュモク ノ ジュ
樺	シラカバ ノ カバ
樽	タルザケ ノ タル
橄	カンランサンノカン，キヘンニユウカンナノカン
橇	セイ，ノリモノノソリ
橈	ドウ，タワム，トウコツノトウ
橋	ホドウキョウ ノ キョウ，ハシ
橘	タチバナ，カンキツ ノ キツ
橙	トウ，ショクブツノダイダイ
機	ヒコウキ ノ キ
橡	キヘン ニ ドウブツ ノ ゾウ，トチ
橢	ダエンケイノダノキュウジ
橦	トウ，キヘンニワラベ
橲	ジサ，キヘンニキゲキノキ
橸	マサ，キヘンニスイショウダマノショウ
橿	カシハラジングウ ノ カシ
檀	ダンカ ノ ダン
檄	ゲキヲトバスノゲキ
檍	ヨク，キヘンニイミガナイノイ
檎	リンゴ ノ ゴ
檐	エン，サンタンタルノタンノツクリ
檗	オウバクシュウノバク，カベノツチノカワリニショクブツノキ
檜	ショクブツノヒノキ，キヘンニカイシャノカイノキュウジ
檠	ケイ，ソンケイスルノケイノシタニモクザイノモク
檢	ケンサスルノケンノキュウジ
檣	ショウ，ホバシラ
檪	クヌギ，レキ，キヘンニオンガクカノガク
檬	モウ，レモンノニモジメ
檮	トウ，キヘンニコトブキノキュウジ
檳	ショクブツノビンロウジュノビン
檸	ネイ，レモンノイチモジメ
檻	セッカンスルノカン，オリ
櫁	ミツ，キヘンニハチミツノミツ
櫂	トウ，フネヲコグカイ
櫃	オヒツノヒツ
櫑	ライ，キヘンニスイデンノデンガミッツ
櫓	ヒノミヤグラ ノ ヤグラ
櫚	シュロノキノロ
櫛	カミヲ トカス クシ
櫞	クエンサンノエン，キヘンニエンガワノエンノキュウジ
櫟	クヌギ，レキ，キヘンニオンガクカノガクノキュウジ
櫨	ハゼノキ ノ ハゼ
櫪	レキ，キヘンニレキシカノレキノキュウジタイ
櫺	レイ，キヘンニアメカンムリニクチミッツ
櫻	サクラノキュウジ
欄	クウラン ノ ラン
欅	ケヤキ，キヘンニセンキョケンノキョノキュウジ
權	ケンリノケンノキュウジ
欒	イッカダンランノラン
欖	カンランサンノラン，キヘンニハクランカイノランノキュウジ
欝	ユウウツナ ノ ウツ
欟	カン，キヘンニカンキャクノカンノキュウジ
欠	ホケツ ノ ケツ，カケル
次	モクジ ノ ジ，ツギ
欣	キンキジャクヤク ノ キン，ヨロコブ
欧	オウベイ ノ オウ
欲	ヨクボウ ノ ヨク，ホシイ
欷	キ，キボウノキニフカケツノケツ
欸	アイ，アイサツノアイノツクリニフカケツノケツ
欹	キ，キミョウナノキニフカケツノケツ
欺	サギ ノ ギ，アザムク
欽	キンテイケンポウ ノ キン
款	エンシャッカン ノ カン
歃	ソウ，ソウニュウクノソウノキュウジノツクリニフカケツノケツ
歇	カンケツセンノケツ，カッショクノカツノツクリニフカケツノケツ
歉	ケン，カネルニフカケツノケツ
歌	ウタ，カシュ ノ カ
歎	ナゲク，タンニショウ ノ タン
歐	オウベイノオウノキュウジ
歓	カンゲイ ノ カン，ヨロコブ
歔	キョ，キョエイシンノキョノキュウジニフカケツノケツ
歙	キュウ，ゴウカクノゴウノシタニウモウノウ，ソノミギニフカケツノケツ
歛	カン，ケンサスルノケンノキュウジノツクリニフカケツノケツ
歟	ヨ，アタエルノキュウジニフカケツノケツ
歡	カンゲイスルノカンノキュウジ
止	キンシスル ノ シ，トメル
正	タダシイ，ショウガツ ノ ショウ
此	ヒガンシガン ノ シ，コノ
武	ブキ ノ ブ
歩	アルク，ホドウ ノ ホ
歪	ヒズム，ワイキョクスル ノ ワイ
歯	ハブラシ ノ ハ，シ
歳	サイゲツ ノ サイ，トシ
歴	レキシ ノ レキ
歸	キタクスルノキ，カエルノキュウジ
歹	ガツ，ブシュノカバネヘン
死	シボウ ノ シ，シヌ
歿	ボツ，カバネヘンニチンボツノボツノキュウジノツクリ
殀	ヨウ，カバネヘンニヨウカイヘンゲノヨウノツクリ
殃	オウ，カバネヘンニチュウオウノオウ
殄	テン，カバネヘンニシンサツスルノシンノツクリ
殆	ホトンド
殉	ジュンキョウシャ ノ ジュン
殊	トクシュ ノ シュ，コトニ
残	ザンネン ノ ザン，ノコル
殍	ヒョウ，カバネヘンニツメノシタニコドモノコ
殕	ホウ，カバネヘンニバイリツノバイノツクリ
殖	ヨウショクスル ノ ショク，フヤス
殘	ザンネンノザン，ノコルノキュウジ
殞	イン，カバネヘンニガッキュウイインノイン
殤	ショウ，カバネヘンニキリキズノツクリ
殪	エイ，カバネヘンニケイヤクショニツカウスウジイチノキュウジ
殫	タン，カバネヘンニタンジュンノタンノキュウジ
殯	ヒン，モガリ，カバネヘンニライヒンノヒン
殱	テキヲセンメツスルノセンノイタイジ
殲	テキヲセンメツスルノセン
殳	シュ，ブシュノルマタ
殴	オウダスル ノ オウ，ナグル
段	シュダン ノ ダン
殷	チュウゴクノオウチョウノイン
殺	サツジン ノ サツ，コロス
殻	カイガラ ノ ガラ，カク
殼	カイガラノカラ，カクノキュウジ
殿	トノサマ ノ トノ
毀	メイヨキソンノキ
毅	キゼントシタ ノ キ
毆	オウダスルノオウ，ナグルノキュウジ
毋	ブ，ナカレ，マイニチノマイノシタガワ
母	フボ ノ ボ，ハハ
毎	マイニチ ノ マイ
毒	ショウドク ノ ドク
毓	イク，マイニチノマイニナガレルノツクリ
比	ヒカクスル ノ ヒ，クラベル
毘	ビシャモンテン ノ ビ
毛	ケイト ノ ケ，ウモウ ノ モウ
毟	ムシル，スクナイノシタニウモウノモウ
毫	キゴウスルノゴウ
毬	マリ，ウモウノモウノミギニモトメル
毯	ジュウタンノタン，ウモウノモウニホノオ
毳	セイ，ウモウノモウガミッツ
氈	モウセンゴケノセン
氏	シメイ ノ シ，ウジ
民	コクミン ノ ミン，タミ
氓	ボウ，ボウメイスルノボウノミギニコクミンノミン
气	キ，ブシュノキガマエ
気	クウキ ノ キ
氛	フン，キガマエニハンブンノブン
氣	クウキノキノキュウジ
氤	イン，キガマエニインガオウホウノイン
水	スイヨウビ ノ スイ，ミズ
氷	ヒョウガ ノ ヒョウ，コオリ
永	エイキュウ ノ エイ，ナガイ
氾	カワガハンランスル ノ ハン
汀	ミギワ，サンズイ ニ イッチョウメ ノ チョウ
汁	ミソシル ノ シル，カジュウ ノ ジュウ
求	ヨウキュウ ノ キュウ，モトメル
汎	ハンヨウセイ ノ ハン
汐	チョウセキ ノ セキ，シオ
汕	サン，サンズイニヤマ
汗	アセ，ハッカン ノ カン
汚	オセン ノ オ，キタナイ
汝	ナンジ，サンズイ ニ オンナ
汞	コウ，ズガコウサクノコウノシタニミズ
江	エドジダイ ノ エ
池	チョスイチ ノ チ，イケ
汢	ヌタ，サンズイニツチ
汨	ベキラノベキ，サンズイニヨウビノニチ
汪	オウ，サンズイニオウサマノオウ
汰	シゼントウタ ノ タ
汲	クム，キュウキュウトスル ノ キュウ
汳	ハン，サンズイニハンタイスルノハン
決	タスウケツ ノ ケツ，キメル
汽	キテキ ノ キ
汾	フン，サンズイニハンブンノブン
沁	シン，シミル，サンズイニココロ
沂	ギ，サンズイニショクパンイッキンノキン
沃	ヒヨクナトチ ノ ヨク
沈	チンボツスル ノ チン，シズム
沌	コントントシタ ノ トン
沍	ゴ，サンズイニタガイ
沐	モクヨクスルノモク
沒	チンボツスルノボツノキュウジ
沓	クツ，ミズ ノ シタニ ヒ
沖	オキ，オキナワケン ノ オキ
沙	ゴブサタ ノ サ，サンズイ ニ スクナイ
沚	シ，サンズイニキンシスルノシ
沛	ハイゼンタルアメのハイ
没	チンボツスル ノ ボツ
沢	コウタク ノ タク，サワ
沫	ホウマツ ノ マツ，サンズイ ニ スエ
沮	イキソソウノソ，サンズイニソシスルノソノツクリ
沱	ダ，サンズイニブッダノダノツクリ
河	サンズイ ノ カワ
沸	フットウスル ノ フツ，ワク
油	セイキユ ノ ユ，アブラ
沺	テン，サンズイニスイデンノデン
治	セイジ ノ ジオサメル
沼	ヌマチ ノ ヌマ，ショウ
沽	コケンニカカワルノコ，サンズイニチュウコヒンノコ
沾	テン，サンズイニドクセンスルノセン
沿	エンガン ノ エン，ソウ
況	ジッキョウチュウケイ ノ キョウ
泄	ハイセツブツノセツ
泅	シュウ，サンズイニシュウジンフクノシュウ
泉	オンセン ノ セン，イズミ
泊	シュクハクスル ノ ハク，トマル
泌	ヒニョウキ ノ ヒ
泓	オウ，サンズイニコウボウタイシノコウ
法	ホウリツ ノ ホウ
泗	シ，サンズイニカンスウジノヨン
泙	ヘイ，サンズイニヘイワノヘイ
泛	ハン，サンズイニビンボウノボウ
泝	ソ，サンズイニハイセキウンドウノセキ
泡	アワ，スイホウ ノ ホウ
波	ツナミ ノ ナミ，ハ
泣	ナク，ゴウキュウスル ノ キュウ
泥	デイスイ ノ デイ，ドロ
注	チュウモクスル ノ チュウ，ソソグ
泪	ナミダノイタイジ，サンズイニモクテキノモク
泯	ビン，サンズイニコクミンノミン
泰	アンタイ ノ タイ
泱	オウ，サンズイニチュウオウノオウ
泳	スイエイ ノ エイ，オヨグ
洋	ヨウフク ノ ヨウ
洌	セイレツナイズミノレツ，サンズイニギョウレツノレツ
洒	オシャレノシャ，サンズイニニシ
洗	センタクモノ ノ セン，アラウ
洙	シュ，サンズイニシュイロノシュ
洛	ジョウラクスル ノ ラク
洞	ドウクツ ノ ドウ，ホラ
洟	ハナミズ，イ，サンズイニジョウイノイ
津	ツナミ ノ ツ，シン
洩	キミツロウエイ ノ エイ，モラス
洪	コウズイ ノ コウ
洫	キョク，サンズイニケツエキノケツ
洲	サンカクス ノ ス，サンズイツキ
洳	ジョ，サンズイニトツジョノジョ
洵	シュン，サンズイニゲジュンノジュン
洶	キョウ，サンズイニムネガイタムノムネノツクリ
洸	コウ，サンズイニヒカリ
活	セイカツ ノ カツ
洽	コウ，サンズイニゴウカクノゴウ
派	ハバツ ノ ハ
流	リュウコウ ノ リュウ，ナガス
浄	ジョウスイキ ノ ジョウ
浅	アサイ フカイ ノ アサイ
浙	セッコウショウノセツ，サンズイニコッセツスルノセツノツクリ
浚	シュセツスルノシュン
浜	スナハマ ノ ハマ
浣	カンチョウスルノカン，サンズイニカンリョウスルノカン
浤	コウ，サンズイニウカンムリニカタカナノナトム
浦	ツツウラウラ ノ ウラ
浩	コウゼン ノ コウ，サンズイ ニ ツゲル
浪	ロウヒスル ノ ロウ
浬	タンイ ノ カイリ，サンズイ ニ サト
浮	フリョク ノ フ，ウク
浴	ニュウヨクスル ノ ヨク，アビル
海	ウミ，カイガイ ノ カイ
浸	シントウスル ノ シン，ヒタス
浹	ショウ，サンズイニセマイノキュウジノツクリ
涅	ネハンノネ
消	ショウボウシャ ノ ショウ，ケス
涌	ワク，コワクダニ ノ ワク
涎	スイゼンノマトノゼン，ヨダレ
涓	ケン，サンズイニキヌイトノキヌノツクリ
涕	テイ，ナミダ，サンズイニオトウト
涙	ナミダ，ルイセン ノ ルイ
涛	トウ，サンズイ ニ コトブキ
涜	ボウトクスル ノ トク，ケガス
涯	イッショウガイ ノ ガイ
液	エキタイ ノ エキ
涵	トクヲカンヨウスルノカン
涸	カレル，サンズイニカタマル
涼	スズシイ，ノウリョウ ノ リョウ
淀	ヨドガワ ノ ヨド
淅	セキ，サンズイニブンセキスルノセキ
淆	ギョクセキコンコウノコウ
淇	キ，サンズイニキホンノキカラツチヲトッタカタチ
淋	サビシイ，サンズイ ニ ハヤシ
淌	ショウ，サンズイニオショウサンノショウ
淑	シュクジョ ノ シュク
淒	セイ，サンズイニツマオットノツマ
淕	リク，サンズイニリクジョウノリクノツクリ
淘	シゼントウタ ノ トウ
淙	ソウ，サンズイニシュウキョウカイカクノシュウ
淞	ショウ，サンズイニマツノキノマツ
淡	タンスイギョ ノ タン，アワイ
淤	オケツノオ，トドコオル
淦	カン，サンズイニキンヨウビノキン
淨	ジョウスイキノジョウノキュウジ
淪	リン，サンズイニケツロンノロンノツクリ
淫	インラン ノ イン，ミダラ
淬	サイ，サンズイニソツギョウノソツ
淮	ワイガノワイ，サンズイニフルトリ
深	シンコクナ ノ シン，フカイ
淳	ジュン，サンズイ ニ キョウラクテキナ ノ キョウ
淵	ミズガ ヨドンデ フカイ フチ
混	コンザツ ノ コン
淹	エン，サンズイニアマミオオシマノイチモジメ
淺	アサイノキュウジ
添	ソエル，テンプスル ノ テン
清	セイケツ ノ セイ，キヨイ
渇	カツボウスル ノ カツ，カワク
済	キュウサイスル ノ サイ，スマス
渉	ダンタイコウショウ ノ ショウ
渊	フチノイタイジ，タテボウニホンノナカニコメ
渋	ジュウタイスル ノ ジュウ，シブイ
渓	ケイリュウヅリ ノ ケイ
渕	フチノイタイジ，サンズイニハナガサクノサクノツクリニリットウ
渙	タイショウカンパツノカン，サンズイニカンキセンノカンノツクリ
渚	ナギサ，ショ
減	ゲンショウスル ノ ゲン，ヘル
渝	ユ，サンズイニニレノキノニレノツクリ
渟	テイ，サンズイニテイシュカンパクノテイ
渠	アンキョ ノ キョ，ミゾ
渡	ハシヲワタル ノ ワタル
渣	サ，サンズイニケンサノサ
渤	ボッカイワンノボツ
渥	アツミハントウ ノ アツ
渦	ウズマキ ノ ウズ，カ
温	オンセン ノ オン，アタタマル
渫	シュンセツスルノセツ
測	ソクテイ ノ ソク，ハカル
渭	イスイノイ，サンズイニイブクロノイ
渮	カ，サンズイニイラツク
港	クウコウ ノ コウ，ミナト
游	ユウ，アソブノシンニョウノカワリニサンズイ
渺	ビョウ，サンズイニモクテキノモクニスクナイ
渾	コンシンノチカラノコン，サンズイニグンタイノグン
湃	ハイ，サンズイニオガムノキュウジ
湊	ミナト，サンズイ ニ カナデル
湍	タン，サンズイニタンマツノタンノツクリ
湎	チンメンスルノメン，サンズイニジメンノメン
湖	コハン ノ コ，ミズウミ
湘	ショウナンカイガン ノ ショウ
湛	ミズヲタタエル ノ タン
湟	コウ，サンズイニコウタイシノコウ
湧	ユウシュツスル ノ ユウ，ワク
湫	シュウ，サンズイニアキマツリノアキ
湮	ショウコインメツノイン，サンズイニケムリノツクリ
湯	ネットウ ノ トウ，ユ
湲	エン，サンズイニオウエンスルノエンノツクリ
湶	セン，サンズイニオンセンノセン
湾	ワンガン ノ ワン
湿	シツド ノ シツ，シメル
満	マンゾク ノ マン
溂	ハツラツノラツ，サンズイニシゲキスルノシ
溌	ゲンキハツラツ ノ ハツ
溏	トウ，サンズイニケントウシノトウ
源	スイゲン ノ ゲン，ミナモト
準	ジュンビスル ノ ジュン
溘	コウ，サンズイニキョネンノキョニサラ
溜	リュウインガサガル ノ リュウ，タマリ
溝	ミゾ，ハイスイコウ ノ コウ
溟	メイ，サンズイニメイフクヲイノルノメイ
溢	アフレル，ノウイッケツ ノ イツ
溥	シンコクコウテイノフギノフ
溪	ケイリュウヅリノケイノキュウジ
溯	ソジョウスルノソ，サンズイニハッサクノサク
溲	ソウ，サンズイニサンバソウノソウ
溶	ヨウエキ ノ ヨウ，トケル
溷	コン，サンズイニクニガマエノナカニブタノツクリ
溺	デキアイスル ノ デキ，オボレル
溽	ジョク，サンズイニブジョクノジョク
滂	ボウ，サンズイニロボウノボウノツクリ
滄	ソウ，サンズイニカマクラバクフノクラ
滅	ハメツスル ノ メツ，ホロビル
滉	コウ，サンズイニホロバシャノホロノツクリ
滋	ジヨウキョウソウ ノ ジ
滌	テキ，サンズイニジョウケンノジョウノキュウジ
滑	エンカツ ノ カツ，ナメラカ
滓	ザンシノシ，サンズイニウカンムリニカライ
滔	ミズガトウトウトナガレルノトウ
滕	トウ，フジノハナノフジノクサカンムリナシ
滝	タキツボ ノ タキ
滞	ジュウタイスル ノ タイ，トドコオル
滬	コ，サンズイニバッコスルノコ
滯	ジュウタイスルノタイ，トドコオルノキュウジ
滲	シン，ニジム，サンズイニサンカスルノサンノキュウジ
滴	スイテキ ノ テキ，シズク
滷	ロ，サンズイニロカクヒンノロ
滸	スイコデンノコ
滾	タギル，コン
滿	マンゾクノマンノキュウジ
漁	ギョコウ ノ ギョ
漂	ヒョウリュウスル ノ ヒョウ，タダヨウ
漆	ウルシヌリ ノ ウルシ，シツ
漉	チャコシ ノ コス
漏	モラス，ロウデン ノ ロウ
漑	カンガイヨウスイノガイ
漓	ボッコンリンリノリ，サンズイニリリクノリノヒダリガワ
演	エンソウスル ノ エン
漕	コグ，ソウテイ ノ ソウ
漠	サハラサバク ノ バク
漢	カンジテスト ノ カン
漣	レン，サザナミ
漫	マンガ ノ マン
漬	ツケモノ ノ ツケル
漱	ナツメソウセキノソウ，ススグ
漲	チョウ，ミナギル
漸	ゼンゾウスル ノ ゼン，ヨウヤク
漾	ヨウ，サンズイニカミサマノカミノキュウジノツクリ
漿	ショウ，ショウグンノショウノキュウジノシタニミズ
潁	エイ，カタカナノヒノシタニミズ，ソノミギニページ
潅	カンボク ノ カン
潔	セイケツ ノ ケツ
潘	ハン，サンズイニバンゴウノバン
潛	センスイカンノセン，モグルノキュウジ
潜	センスイカン ノ セン，モグル
潟	ニイガタケン ノ カタ
潤	リジュン ノ ジュン，ウルオウ
潦	ロウ，サンズイニメイリョウナノリョウノツクリ
潭	タン，サンズイニニシノシタニハヤオキノハヤイ
潮	マンチョウ ノ チョウ，シオ
潯	ジン，サンズイニジンジョウショウガッコウノジン
潰	ツブレル，イカイヨウ ノ カイ
潴	チョ，サンズイニイノシシ
潸	サン，サンズイニハヤシノシタニツキ
潺	サン，サンズイニシカバネノシタニコドモノコミッツ
潼	トウ，サンズイニグリムドウワノドウ
澀	ジュウタイスルノジュウ，シブイノノキュウジノイタイジ
澁	ジュウタイスルノジュウ，シブイノキュウジ
澂	ミズガスムノスムノイタイジ
澄	ミズガスム ノ スム
澆	ギョウ，サンズイニギョウシュンノギョウノキュウジ
澎	ホウ，サンズイニツヅミノヒダリガワニサンヅクリ
澑	リュウインガサガルノリュウ，タマリノイタイジ
澗	カン，サンズイ ニ アイダ
澡	ソウ，サンズイニソウジュウスルノソウノツクリ
澣	カン，サンズイニシンカンセンノカン
澤	コウタクノタク，サワノキュウジ
澪	ミオツクシノミオ，レイ
澱	チンデンスル ノ デン，ヨドム
澳	オウ，サンズイニオクバノオクノキュウジ
澹	アンタンタルクモユキノタン
激	カゲキ ノ ゲキ，ハゲシイ
濁	ニゴル，ダクリュウ ノ ダク
濂	レン，サンズイニレンカバンノレン
濃	ノウタン ノ ノウ，コイ
濆	フン，サンズイニフンカスルノフンノツクリ
濔	ビ，サンズイニソツジナガラノジ
濕	シツドノシツ，シメルノキュウジ
濘	デイネイノネイ，サンズイニテイネイノネイ
濛	モウ，サンズイニケイモウスルノモウ
濟	キュウサイスルノサイ，スマスノキュウジ
濠	ゴウ，サンズイ ニ ゴウカイナ ノ ゴウ
濡	ヌレル
濤	ドトウノトウ，ナミ
濫	カセン ノ ハンラン ノ ラン
濬	シュン，サンズイニヒエイザンノエイノヒダリガワ
濮	ボク，サンズイニイチニンショウノボク
濯	センタクモノ ノ タク
濱	スナハマノハマノキュウジ
濳	センスイカンノセン，モグルノイタイジ
濶	ウカツナノカツノイタイジ
濺	セン，サンズイニゲセンナノセン
濾	ロカスルノロ，コス
瀁	ヨウ，サンズイニヤシナウ
瀉	イッシャセンリノシャ，サンズイニシャシンノシャノキュウジ
瀋	チュウゴクノシンヨウノシン，サンズイニシンサスルノシン
瀏	リュウ，サンズイニリュウホウノリュウ
瀑	ナイアガラバクフノバク
瀕	ヒンシ ノ ジュウショウ ノ ヒン
瀘	ロ，サンズイニハゼノキノハゼノツクリ
瀚	コウカンナゾウショノカン
瀛	ウミヲイミスルサンズイノエイ
瀝	ヒレキスルノレキ
瀞	ナガトロ ノ トロ，サンズイ ニ シズカ
瀟	ショウシャナタテモノノショウ
瀦	ミズタマリヲ イミスル チョ
瀧	タキ ノ キュウジ
瀬	セトモノ ノ セ
瀰	ビ，サンズイニアミダブツノミノキュウジ
瀲	レン，サンズイニイッテンニシュウレンスルノレン
瀾	ハランバンジョウノラン
灌	カンガイヨウスイノカン
灑	サイ，サンズイニチュウカナベノカ
灘	ナダ，サンズイ ニ ムズカシイ
灣	ワンガンノワンノキュウジ
火	カヨウビ ノ カ，ヒ
灯	ケイコウトウ ノ トウ
灰	ハイイロ ノ ハイ
灸	オキュウヲスエル ノ キュウ
灼	シャクネツ ノ シャク
災	サイナン ノ サイ，ワザワイ
炉	ダンロ ノ ロ
炊	スイハンキ ノ スイ，タク
炎	エンジョウスル ノ エン，ホノオ
炒	イタメル，チャーハンノイチモジメ
炙	ジンコウニカイシャスルノシャ，アブル
炬	キョ，カガリビ，ヒヘンニキョダイナノキョ
炭	セキタン ノ タン，スミ
炮	ホウ，ヒヘンニツツム
炯	ケイガンノシノケイ，ヒヘンニドウガマエニクチ
炳	ヘイ，ヒヘンニコウオツヘイノヘイ
炸	バクダンガサクレツスルノサク
点	テンスウ ノ テン
為	コウイ ノ イ，タメ
烈	キョウレツナ ノ レツ
烋	コウ，キュウジツノキュウニレンガ
烏	ウゴウノシュウ ノ ウ，カラス
烙	ラクインヲオスノラク
烝	ジョウ，スイジョウキノジョウからクサカンムリヲトッタカタチ
烟	エントツノエンノイタイジ，ヒヘンニインガオウホウのイン
烱	ヒヘンケイガンノシノケイノイタイジ
烹	カッポウギ ノ ホウ
烽	ノロシヲイミスルホウ，ヒヘンニミネノツクリ
焉	シュウエンノチノエン
焔	ホノオ，ヒヘン ノ ホノオ
焙	バイセンスルノバイ，アブル
焚	フンショコウジュ ノ フン，タキビ ノ タキ
焜	コン，ヒヘンニコンチュウノコン
無	ムリ ノ ム，ナイ
焦	ショウテンキョリ ノ ショウ
然	ダイシゼン ノ ゼン
焼	ニクヲヤク ノ ヤク
煉	レンガ ノ レン，ネル
煌	コウ，ヒヘンニコウタイシノコウ
煎	センチャ ノ セン，イル
煕	コウキジテンノキ
煖	ダン，ヒヘンニダンボウノダンノツクリ
煙	エントツ ノ エン，ケムリ
煢	ケイ，ホタルノキュウジノカンムリニジンソクナノジンノナカミ
煤	スス，バイエン ノ バイ
煥	サイキカンパツノカン
煦	ク，ヨウビノニチノミギニハイクノクニレンガ
照	ショウメイ ノ ショウ，テラス
煩	ボンノウ ノ ボン，ワズラワシイ
煬	ヨウ，ヒヘンニタイヨウケイノヨウノツクリ
煮	ニモノ ノ ニ，シャフツ ノ シャ
煽	アオル，センドウスル ノ セン
熄	ソク，ヒヘンニイキヲスルノイキ
熈	コウキジテンノキノイタイジ
熊	ドウブツ ノ クマ
熏	クンセイノクン，クスベル
熔	ヨウガン ノ ヨウ，ヒヘン ニ ナイヨウ ノ ヨウ
熕	コウ，ヒヘンニシャカイコウケンノコウ
熙	キ，モトシュショウノホソカワモリヒロノヒロ
熟	ジュクゴ ノ ジュク，ジュクスル
熨	ノシ，リクグンタイイノイノシタニカヨウビノカ
熬	ゴウ，ゴウマンナノゴウノツクリニレンガ
熱	ネツ，アツイ
熹	キ，キゲキノキニレンガ
熾	シレツナノシ
燃	ネンリョウ ノ ネン，モエル
燈	トウダイ ノ トウ，ヒヘン ニ ノボル
燉	トン，ヒヘンニチュウゴクノトンコウノトン
燎	リョウゲンノヒノリョウ
燐	リンサンヒリョウ ノ リン
燒	ニクヲヤクノヤクノキュウジ
燔	ハン，ヒヘンニバンゴウノバン
燕	ツバメ
燗	アツカンノカン
營	エイギョウノエイ，イトナムノキュウジ
燠	イク，ヒヘンニオクバノオクノキュウジ
燥	カンソウキ ノ ソウ
燦	サンゼントカガヤク ノ サン
燧	スイ，ヒヘンニトゲルノキュウジ
燬	キ，ヒヘンニメイヨキソンノキ
燭	ショクダイ ノ ショク，ロウソク ノ ソク
燮	チョウワサセルノイミノショウ
燵	コタツノタツ
燹	セン，ブタノツクリフタツノシタニカヨウビノカ
燻	クンセイノクン，クスベルノイタイジ
燼	カイジンニキスノジン
燿	ヨウ，ヒヘンニニチヨウビノヨウノツクリ
爆	バクハツスル ノ バク
爍	シャク，ヒヘンニタノシイノキュウジ
爐	ダンロノロノキュウジ
爛	テンシンランマンノラン
爨	ハンゴウスイサンノサン
爪	ツメキリ ノ ツメ
爬	ハチュウルイノハ
爭	アラソウノキュウジ
爰	オウエンスルノエンノキュウジノツクリ
爲	コウイノイ，タメノキュウジ
爵	ハクシャク ノ シャク
父	フボ ノ フ，チチ
爺	コウコウヤ ノ ヤ，ジイ
爻	コウ，ハンバクスルノバクノツクリ
爼	マナイタ，ソジョウノソノイタイジ
爽	サワヤカ，ソウカイナ ノ ソウ
爾	ソツジナガラ ノ ジ，ナンジ
爿	ショウヘン，ショウグンノショウノキュウジノヘン
牀	コシカケノショウギノショウ，ショウヘンニクサキノキ
牆	ショウ，カキ，ショウヘンニリンショクノショク
片	カタオモイ ノ カタ，ヘン
版	モクハンガ ノ ハン
牋	ショホウセンノセンノイタイジ
牌	イハイ ノ ハイ，フダ
牒	サイゴツウチョウ ノ チョウ，フダ
牘	トク，カタヘンニハンバイスルノバイノキュウジ
牙	ゾウゲ ノ ゲ，キバ
牛	ウシ，ギュウニュウ ノ ギュウ
牝	ヒンバ ノ ヒン，メス
牟	シャカムニ ノ ム，ム ノ シタニ ウシ
牡	ハナ ノ ボタン ノ ボ，オス
牢	ロウヤ ノ ロウ
牧	ボクジョウ ノ ボク
物	ドウブツ ノ ブツ，モノ
牲	ギセイシャ ノ セイ
牴	テイ，ウシヘンニヒクイノツクリ
特	トクベツ ノ トク
牽	ケンインスル ノ ケン
牾	ゴ，ウシヘンニコクゴノゴノツクリ
犀	ドウブツ ノ サイ
犁	レイ，カラスキノイタイジ
犂	レイ，カラスキ
犇	ホン，ヒシメク，ドウブツノウシミッツ
犒	コウ，ウシヘンニタカイヒクイノタカイ
犖	ラク，ホタルノキュウジノムシノカワリニドウブツノウシ
犠	ギセイシャ ノ ギ
犢	トク，コウシ，ウシヘンニハンバイスルノバイノキュウジ
犧	ギセイシャノギノキュウジ
犬	イヌ，モウドウケン ノ ケン
犯	ハンザイ ノ ハン
犲	サイ，ケモノヘンニカタカナノオ
状	ネンガジョウ ノ ジョウ
犹	ユウ，ケモノヘンニセツゾクシノモットモ
狂	クルウ，キョウゲン ノ キョウ
狃	ジュウ，ケモノヘンニジュウニシノウシ
狄	ナンバンホクテキノテキ
狆	イヌノチン
狎	コウ，ナレル，ケモノヘンニコウオツノコウ
狐	キツネ
狒	ドウブツノヒヒノヒ
狗	テング ノ ク，イヌ
狙	ソゲキ ノ ソ，ネラウ
狛	コマイヌ ノ コマ，ケモノヘン ニ シロ
狠	コン，ケモノヘンニダイコンノコンノツクリ
狡	コウカツナノコウ，ズルイ
狢	ケモノヘンノドウブツノムジナ
狩	シュリョウ ノ シュ，カリ
独	ドクリツ ノ ドク
狭	セマイ，キョウ
狷	ケンカイナノケン，ケモノヘンニキヌイトノキヌノツクリ
狸	タヌキ
狹	キョウ，セマイノキュウジ
狼	オオカミ，ロウバイスル ノ ロウ
狽	ロウバイスル ノ バイ
猊	ゲイカノゲイ
猖	ショウケツヲキワメルノショウ
猗	イ，ケモノヘンニキミョウナノキ
猛	モウショ ノ モウ
猜	サイギシンノサイ
猝	ソツ，ケモノヘンニソツギョウノソツ
猟	リョウジュウ ノ リョウ
猥	ヒワイナノワイ
猩	ショウコウネツノショウ，ケモノヘンニホシ
猪	イノシシ，チョトツモウシン ノ チョ
猫	ヤマネコ ノ ネコ
献	ケンケツスル ノ ケン
猯	タン，ケモノヘンニマッタンノタンノツクリ
猴	コウ，ケモノヘンニオウコウキゾクノコウ
猶	ユウヨスル ノ ユウ
猷	ハカリゴトヲ イミスル ユウ
猾	コウカツナジンブツノカツ，ケモノヘンニホネ
猿	ルイジンエン ノ エン，サル
獄	ジゴク ノ ゴク
獅	シシマイ ノ イチモジメ ノ シ
獎	ショウガクキンノショウノキュウジノイタイジ
獏	ケモノヘンノドウブツノバク
獗	ショウケツヲキワメルノケツ
獣	ヤジュウ ノ ジュウ，ケモノ
獨	ドクリツノドクノキュウジ
獪	ロウカイナノカイ
獰	ドウモウナノドウ
獲	カクトク ノ カク，エル
獵	リョウジュウノリョウノキュウジ
獸	ヤジュウノジュウ，ケモノノキュウジ
獺	ドウブツノカワウソ
獻	ケンケツスルノケンノキュウジ
玄	ゲンマイ ノ ゲン
率	ヒリツ ノ リツ，ヒキイル
玉	ミズタマ ノ タマ，ギョク
王	オウサマ ノ オウ
玖	オウヘン ニ ヒサシイ ノ ク
玩	ガング ノ ガン，モテアソブ
玲	レイロウナ ノ レイ，オウヘン ニ メイレイ ノ レイ
玳	ドウブツノタイマイノタイ，オウヘンニダイヒョウノダイ
玻	ハ，オウヘンニケガワノカワ
珀	コハクイロノハク
珂	オウヘン ニ カノウセイ ノ カ
珈	カ，コーヒーノアテジノイチモジメ
珊	サンゴショウ ノ サン
珍	メズラシイ，チンミ ノ チン
珎	メズラシイ，チンミノチンノイタイジ
珞	ラク，オウヘンニカクジノカク
珠	シュザン ノ シュ，タマ
珥	ジ，オウヘンニミミ
珪	オウヘン ニ ツチ フタツ ノ ケイ，ケイソウド ノ ケイ
班	ハンチョウ ノ ハン
珮	ハイ，ハイヨウスルノハイノニンベンノカワリニオウヘン
珱	ヨウ，オウヘンニサクラノツクリ
珸	ゴ，オウヘンニコクゴノゴノツクリ
現	ゲンジツ ノ ゲン，アラワレル
球	チキュウ ノ キュウ，タマ
琅	ロウ，オウヘンニカイリョウスルノリョウ
理	リユウ ノ リ
琉	リュウキュウ ノ リュウ
琢	セッサタクマ ノ タク，ミガク
琥	コハクイロノコ
琲	ハイ，コーヒーノアテジノニモジメ
琳	オウヘン ニ ハヤシ ノ リン
琴	モッキン ノ キン，コト
琵	ビワコ ノ ビ
琶	ビワコ ノ ニモジメ ノ ハ
琺	ホウロウナベノホウ，オウヘンニホウリツノホウ
琿	コン，オウヘンニグンタイノグン
瑁	ドウブツノタイマイノマイ
瑕	キズヲイミスルカシノカ
瑙	メノウノノウ
瑚	サンゴショウ ノ ゴ
瑛	オウヘン ニ エイゴ ノ エイ
瑜	ユ，オウヘンニニレノキノニレノツクリ
瑞	ズイウン ノ ズイ，シルシ
瑟	キンシツアイワスノシツ
瑠	ルリイロ ノ ル
瑣	ハンサナテツヅキノサ
瑤	ヨウ，オウヘンニユレルノツクリノキュウジ
瑩	ホタルノキュウジノムシノカワリニタマ
瑪	メノウノメ
瑯	ホウロウナベノロウ，オウヘンニモモタロウノロウ
瑰	オウヘンニオニ
瑳	セッサタクマ ノ サ，オウヘン ニ サ
瑶	ヨウ，オウヘンニユレルノツクリ
瑾	キン，キズヲイミスルカキンノキン
璃	ルリイロ ノ リ
璋	ショウ，オウヘンニブンショウヲカクノショウ
璞	ハク，アラタマ，オウヘンニシモベノツクリ
璢	ルリイロノルノイタイジ
璧	ヘキ，カンペキナノヘキ
環	シゼンカンキョウ ノ カン
璽	ギョメイギョジ ノ ジ
瓊	ケイ，ヤサカニノマガタマノニ
瓏	レイロウタルノロウ，オウヘンニキョウリュウノリュウノキュウジ
瓔	ヨウ，オウヘンニサクラノキュウジノツクリ
瓜	ウリ，スイカ ノ カ
瓠	コ，ヒサゴ，ハカマノツクリニウリ
瓢	ヒョウタン ノ ヒョウ，ヒサゴ
瓣	ハナビラノベンノキュウジ
瓦	レンガ ノ ガ，カワラ
瓧	デカグラム，カワラニカンスウジノジュウ
瓩	キログラム，カワラニカンスウジノセン
瓮	オウ，オオヤケノシタニカワラ
瓰	デシグラム，カワラニハンブンニスルノブン
瓱	ミリグラム，カワラニウモウノモウ
瓲	トン，カワラニチュウトンスルノトン
瓶	アキビン ノ ビン
瓷	シ，カワラノウエニモクジノジ
瓸	ヘクトグラム，カワラニカンスウジノヒャク
甃	シュウ，カワラノウエニキセツノアキ
甄	ケン，ケムリノツクリノミギニカワラ
甅	センチグラム，カワラノミギニタンイノリン
甌	オウ，クベツノクノキュウジノミギニカワラ
甍	ボウ，イラカ
甎	セン，センモンカノセンノキュウジノミギニカワラ
甑	モノヲムス コシキ
甓	ヘキ，カベノツチノカワリニカワラ
甕	オウ，カメ，ヨウリツスルノヨウノツクリノシタニカワラ
甘	アマイ，カンミリョウ ノ カン
甚	ジンダイナ ノ ジン，ハナハダシイ
甜	テンサイトウ ノ テン
甞	ガシンショウタンノショウノイタイジ
生	イキル，セイカツ ノ セイ
産	ザイサン ノ サン
甥	オイメイ ノ オイ
甦	ソ，ヨミガエル，サラシナノサラニジドウセイトノセイ
用	リヨウスル ノ ヨウ，モチイル
甫	シジン ノ トホ ノ ホ
甬	ヨウ，ニホンブヨウノヨウノツクリ
田	スイデン ノ デン，タ
由	リユウ ノ ユウ
甲	コウオツ ノ コウ
申	シンコクスル ノ シン，モウス
男	オトコ，ダンシ ノ ダン
甸	デン，ツツミガマエニタンボノタ
町	マチ，シチョウソン ノ チョウ
画	ガヨウシ ノ ガ
甼	マチ，シチョウソンノチョウノイタイジ
畄	リュウガクノリュウノイタイジ
畆	メンセキノタンイノセ，ウネノイタイジ
畉	フ，タガヤス，タヘンニオット
畊	コウ，タガヤスノイタイジ
畋	テン，スイデンノデンニノブン
界	セカイ ノ カイ
畍	セカイノカイノイタイジ
畏	イフスル ノ イ，カシコマル
畑	タハタ ノ ハタ，ハタケ
畔	コハン ノ ハン，ホトリ
留	リュウガク ノ リュウ
畚	ホン，オマイリノマイノサンズクリノカワリニスイデンノデン
畛	シン，アゼ，タヘンニシンサツスルノシンノツクリ
畜	カチク ノ チク
畝	ハタケ ノ ウネ，メンセキ ノ タンイ ノ セ
畠	ハタケ，シロ ノ シタニ タ
畢	ヒッキョウ ノ ヒツ，オワル
畤	ジ，タヘンニテラ
略	リャクゴ ノ リャク
畦	アゼミチ ノ アゼ，タ ニ ツチ フタツ
畧	リャクゴノリャクノイタイジ
畩	ケサ，タヘンニコロモガエノコロモ
番	バンゴウ ノ バン
畫	ガヨウシノガノキュウジ
畭	ヨ，タヘンニアマリ
異	イコク ノ イ，コトナル
畳	タタミ，ヨジョウハン ノ ジョウ
畴	ハン，タヘンニコトブキ
當	トウバンノトウ，アタルノキュウジ
畷	シジョウナワテシ ノ ナワテ
畸	キ，タヘンニキミョウナノキ
畿	キンキチホウ ノ キ
疂	タタミノキュウジノチュウオウガヘンカシタイタイジ
疆	シンキョウウイグルジチクノキョウ
疇	ハンチュウノハン，タヘンニコトブキノキュウジ
疉	タタミノキュウジノシタガヘンカシタイタイジ
疊	タタミノキュウジ
疋	オリモノ ノ タンイ ノ ヒキ
疎	カソチ ノ ソ
疏	ソスイ ノ ソ，ベンソ ノ ソ
疑	ギモン ノ ギ，ウタガウ
疔	メンチョウノチョウ
疚	キュウ，ヤマイダレニエイキュウノキュウ
疝	センキモチノセン，ヤマイダレニヤマ
疣	イボ，ユウ，ヤマイダレニモットモ
疥	ヒフビョウノカイセンノカイ，ヤマイダレニカイゴノカイ
疫	メンエキ ノ エキ
疱	ミズボウソウノホウ
疲	ツカレル，ヒロウスル ノ ヒ
疳	カン，ヤマイダレニアマイ
疵	キズ，ヤマイダレニヒガンシガンノシ
疸	オウダンノダン，ヤマイダレニガンタンノタン
疹	フウシン ノ シン
疼	トウツウノトウ，ウズク
疽	エソヲオコスノソ
疾	シッペイ ノ シツ
痂	カ，カサブタ，ヤマイダレニカソクドノカ
痃	ケン，ヤマイダレニゲンマイノゲン
病	ビョウキ ノ ビョウ，ヤマイ
症	カフンショウ ノ ショウ
痊	セン，ヤマイダレニゼンコクノゼン
痍	ショウイグンジンノイ
痒	カッカソウヨウノヨウ，カユイ
痔	イボジ ノ ジ
痕	コンセキヲ ノコス ノ コン
痘	テンネントウ ノ トウ
痙	イケイレンノケイ
痛	ズツウ ノ ツウ，イタイ
痞	ヒ，ヤマイダレニヒテイスルノヒ
痢	ゲリヲスル ノ リ
痣	アザ，ヤマイダレニココロザシ
痩	ヤセル，ソウシン ノ ソウ
痰	タンガカラムノタン
痲	ヤマイダレノマヒスルノマ
痳	リン，ヤマイダレニハヤシ
痴	グチ ノ チ
痺	マヒスルノヒ，シビレル
痼	ジビョウヲイミスルコシツノコ
痾	ア，ヤマイダレニアミダブツノア
痿	イ，ヤマイダレニガッキュウイインノイ
瘁	スイ，ヤマイダレニソツギョウノソツ
瘉	ユ，ヤマイダレニニレノキノツクリ
瘋	フウテンノフウ，ヤマイダレニカゼ
瘍	イカイヨウノヨウ
瘟	オン，ヤマイダレニオンセンノオンノキュウジノツクリ
瘠	セキ，ヤマイダレニセキズイノセキ
瘡	ミズボウソウノソウ
瘢	ハンコンノハン，ヤマイダレニイッパンテキノハン
瘤	ドウミャクリュウノリュウ，コブ
瘧	オコリ，ヤマイダレニギャクタイノギャク
瘰	ルイレキノルイ，ヤマイダレニルイセキスルノルイ
瘴	ショウ，ヤマイダレニブンショウヲカクノショウ
瘻	ジロウノロウ，ヤマイダレニカズノキュウジノヒダリガワ
療	チリョウスル ノ リョウ
癆	ロウガイノロウ，ヤマイダレニロウドウノロウノキュウジ
癇	カンシャクヲオコスノカン
癈	ハイジンノハイ，ヤマイダレニハツメイノハツノキュウジ
癌	ガンサイボウ ノ ガン
癒	チユスル ノ ユ，イヤス
癖	アクヘキ ノ ヘキ，クセ
癘	ショウレイノレイ，ヤマイダレニスウジノマンノキュウジ
癜	ヒフビョウノナマズ，テン，ヤマイダレニトノサマノトノ
癡	グチノチノキュウジ
癢	ヨウ，ヤマイダレニヤシナウ
癧	ルイレキノレキ，ヤマイダレニレキシカノレキノキュウジ
癨	カク，ヤマイダレニオニノカクランノカク
癩	ライビョウノライ
癪	カンシャクヲオコスノシャク
癬	カイセンキンノセン
癰	ヒフビョウノヨウ
癲	テンカンヲオコスノテン
癶	ハツ，ブシュノハツガシラ
癸	キ，ジッカンノミズノト
発	ハツメイ ノ ハツ
登	トザン ノ ト，ノボル
發	ハツメイノハツノキュウジ
白	シロイ，ハクチョウ ノ ハク
百	カンスウジ ノ ヒャク
皀	キョウ，ハクチョウノハクノシタニカタカナノヒ
皃	ビボウヲタモツノボウノイタイジ
的	モクテキ ノ テキ
皆	ミナサマ ノ ミナ，カイ
皇	コウタイシ ノ コウ
皈	キタクスルノキ，カエルノイタイジ
皋	ショクブツノサツキノイタイジ
皎	コウ，シロヘンニマジワル
皐	ショクブツ ノ サツキ
皓	メイボウコウシノコウ，シロヘンニツゲル
皖	カン，シロヘンニカンリョウスルノカン
皙	セキ，ブンセキスルノセキノシタニハクチョウノハク
皚	ガイ，シロヘンニヨロイノツクリ
皮	カワヲムク ノ カワ，ヒ
皰	ニキビ，ホウ，ケガワノカワニツツム
皴	シュン，シュンビンサノシュンノツクリニケガワノカワ
皷	ツヅミノイタイジ，ツクリガケガワノカワ
皸	クン，ショウグンノグンノミギニケガワノカワ
皹	クン，ショウグンノグンノヒダリニケガワノカワ
皺	シワヲノバスノシワ
皿	サラウドン ノ サラ
盂	ウラボンノウ
盃	サカズキ，フシギ ノ フ ノ シタニ サラ
盆	ボンオドリ ノ ボン
盈	ミチル，エイ
益	リエキ ノ エキ
盍	コウ，フタカラクサカンムリヲトッタカタチ
盒	ハンゴウスイサンノゴウ
盖	フタノイタイジ，サラノウエニヒツジ
盗	トウナン ノ トウ，ヌスム
盛	オオモリ ノ モリ，セイ
盜	トウナンノトウ，ヌスムノキュウジ
盞	サン，サラノウエニアサイノキュウジノツクリ
盟	ドウメイスル ノ メイ
盡	ジンリョクスルノジン，ツクスノキュウジ
監	カントクスル ノ カン
盤	エンバンナゲ ノ バン
盥	タライ，カン
盧	ロ，ロカスルノロノツクリ
盪	ノウシントウノトウ
目	モクテキ ノ モク，メ
盲	モウガッコウ ノ モウ
直	チョクセン ノ チョク，ナオル
相	ソウダンスル ノ ソウ，アイ
盻	ケイ，メヘンニカンスウジノハチノシタニバンゴウノゴウノシタガワ
盾	ムジュン ノ ジュン，タテ
省	ショウリャクスル ノ ショウ，ハブク
眄	ウコサベンノベン
眇	タメツスガメツノスガメ
眈	コシタンタンノタン
眉	マユ，ハクビ ノ ビ
看	カンビョウ ノ カン
県	トドウフケン ノ ケン
眛	マイ，メヘンニミライノミ
眞	マゴコロノマノキュウジ
真	マゴコロ ノ マ，シン
眠	ネムル，スイミン ノ ミン
眤	ジツ，メヘンニアマデラノアマ
眥	シ，ヒガンシガンノシノシタニモクテキノモク
眦	シ，メヘンニヒガンシガンノシ
眩	ゲンワクスルノゲン，マブシイ
眷	サイシケンゾクノケン
眸	メイボウコウシノボウ
眺	ナガメル，チョウボウ ノ チョウ
眼	ソウガンキョウ ノ ガン
着	キモノ ノ キ，チャク
睇	テイ，メヘンニアニオトウトノオトウト
睚	ガイ，メヘンニイッショウガイノガイノツクリ
睛	ガリョウテンセイヲカクノセイ，ヒトミ
睡	スイミン ノ スイ
督	エイガカントク ノ トク
睥	ヘイゲイスルノヘイ，ニラム
睦	シンボクカイ ノ ボク，ムツマジイイ
睨	ヘイゲイスルノゲイ，ニラム
睫	マツゲ，ショウ
睹	ト，メヘンニカガクシャノシャノキュウジタイ
睾	ダンセイノコウガンノコウ
睿	エイ，ヒエイザンノエイノヒダリガワ
瞋	シン，メヘンニマゴコロノマノキュウジ
瞎	カツ，メヘンニサイガイノガイノキュウジタイ
瞑	メイモクスルノメイ
瞞	ギマンニミチタノマン
瞠	ドウ，メヘンニドウモクスルノドウ
瞥	イチベツスル ノ ベツ
瞬	シュンカン ノ シュン，マタタク
瞭	メイリョウナ ノ リョウ
瞰	チョウカンズノカン，ミオロス
瞳	ヒトミ，ドウコウ ノ ドウ
瞶	キ，メヘンニキチョウヒンノキ
瞹	アイ，メヘンニアイスルノアイ
瞻	セン，メヘンニタンニンノタンノキュウジノツクリ
瞼	マブタ，ガンケンノケン
瞽	コ，ツヅミノシタニモクテキノモク
瞿	キョウクスルノクノツクリ，メガフタツノシタニフルトリ
矇	モウ，メヘンニケイモウスルノモウ
矍	ゲンキカクシャクノカク
矗	チク，チョクゼンノチョクガミッツ
矚	ショク，メヘンニフゾクノゾクノキュウジ
矛	ムジュン ノ ム，ホコ
矜	キョウジヲタモツノキョウ
矢	ユミヤ ノ ヤ
矣	イ，アイサツノアイノツクリ
知	チシキ ノ チ，シル
矧	ヤヘン ニ インヨウスル ノ イン，ハグ
矩	クケイ ノ ク
短	チョウタン ノ タン，ミジカイ
矮	ワイショウナノワイ
矯	キョウセイシリョク ノ キョウ
石	ホウセキ ノ セキ，イシ
矼	コウ，イシヘンニズガコウサクノコウ
砂	サトウ ノ サ，スナ
砌	セイ，ミギリ，イシヘンニセツジツナノセツ
砒	ゲンソノヒソノヒ
研	ケンキュウ ノ ケン
砕	クダク，フンサイスル ノ サイ
砠	ショ，イシヘンニクミノツクリ
砥	トイシ ノ ト
砦	トリデ，コレ ノ シタニ イシ
砧	キヌタ，イシヘン ニ ウラナウ
砲	ホウガンナゲ ノ ホウ
破	ハカイスル ノ ハ，ヤブル
砺	レイ，イシヘン ニ ガンダレ ニ マン
砿	イシヘン ニ ヒロイ ノ コウ
硅	ゲンソノケイソノケイ，イシヘンニツチフタツ
硝	ショウサンエン ノ ショウ
硫	リュウサン ノ リュウ
硬	ヒャクエンコウカ ノ コウ，カタイ
硯	スズリ
硲	ハザマ，イシヘン ニ タニ
硴	カキ，イシヘンニハナビノハナ
硼	ゲンソノホウソノホウ
碁	ゴイシ ノ ゴ
碆	ハ，ハチョウガアウノハノシタニイシバシノイシ
碇	テイハク ノ テイ，イカリ
碌	ロク，イシヘンニミドリノキュウジノツクリ
碍	ユウズウムゲ ノ ゲ，ガイ
碎	クダク，フンサイスルノサイノキュウジ
碑	キネンノヒ ノ ヒ，イシブミ
碓	ウス，イシヘン ニ フルトリ
碕	イシヘン ニ キミョウナ ノ キ
碗	イシヘン ノ チャワン ノ ワン
碚	ハイ，イシヘンニバイリツノバイノツクリ
碣	ケツ，イシヘンニカッショクノカツノツクリ
碧	ヘキガン ノ ヘキ
碩	セキガク ノ セキ，イシヘン ニ ページ
碪	キヌタ，イシヘンニハナハダシイ
碯	ノウ，イシヘンニズノウノノウノキュウジノツクリ
碵	セキ，イシヘンニテイシュクノテイ
確	カクニン ノ カク，タシカ
碼	ナガサノタンイノヤード
碾	テン，イシヘンニハッテンノテン
磁	ジシャク ノ ジ
磅	オモサノタンイノポンド
磆	カツ，イシヘンニホネ
磊	ゴウホウライラクノライ
磋	セッサタクマノサ，イシヘンニサ
磐	ジョウバンセン ノ バン
磑	ガイ，イシヘンニヨロイノツクリ
磔	タッケイノタク，ハリツケ
磚	セン，カワラ，イシヘンニセンモンノセンノキュウジ
磧	セキ，カワラ，イシヘンニセキニンノセキ
磨	ケンマスル ノ マ，ミガク
磬	ケイ，コエノキュウジノミミノカワリニイシ
磯	イソヅリ ノ イソ
磴	トウ，イシヘンニトザンノト
磽	コウ，イシヘンニギョウシュンノギョウノキュウジ
礁	サンゴショウ ノ ショウ
礇	イキ，イシヘンニオクバノオクノキュウジ
礎	キソテキナ ノ ソ，イシズエ
礑	トウ，イシヘンニベントウノトウノキュウジ
礒	ギ，イシヘンニギムノギ
礙	ガイ，イシヘンニウタガウ
礦	コウ，イシヘンニヒロバノヒロノキュウジ
礪	トナミヘイヤノト
礫	ガレキノレキ
礬	コウブツノミョウバンノバン
示	テンジスル ノ ジ，シメス
礼	レイギ ノ レイ
社	シャカイ ノ シャ，ヤシロ
祀	サイシノシ，マツル
祁	シメスヘン ニ オオザト ノ キ
祇	ギオンマツリ ノ ギ
祈	イノル，キガンスル ノ キ
祉	シャカイフクシ ノ シ
祐	テンユウ ノ ユウ，シメスヘン ニ ミギ
祓	ハライキヨメルノハライ，フツ
祕	ヒミツノヒノキュウジ
祖	ソセン ノ ソ
祗	シ，シメスヘンニヒクイノツクリ
祚	クライヲウケツグセンソノソ
祝	シュクジツ ノ シュク，イワウ
神	カミサマ ノ カミ，シン
祟	タタル，スイ
祠	シ，ホコラ，シメスヘンニシカイシャノシ
祢	ネ，シメスヘン ニ ナンジ ノ イタイジ
祥	フショウジ ノ ショウ
票	トウヒョウスル ノ ヒョウ
祭	サイジツ ノ サイ，マツリ
祷	モクトウスル ノ トウ，イノル
祺	キ，シメスヘンニソレ
祿	ゲンロクブンカノロクノキュウジ
禀	リンギショノリンノイタイジ
禁	キンシスル ノ キン
禄	ゲンロクブンカ ノ ロク
禅	ザゼン ノ ゼン
禊	ミソギ，ケイ
禍	ワザワイ，カ
禎	テイ，シメスヘン ニ テイシュク ノ テイ
福	フクビキ ノ フク
禝	シャショクノシンノショク，シメスヘン
禦	ボウギョ ノ ギョ ノ キュウジ
禧	キ，シメスヘンニヨロコブ
禪	ザゼンノゼンノキュウジ
禮	レイギノレイノキュウジ
禰	スクネ ノ ネ，シメスヘン ニ ナンジ
禳	ジョウ，シメスヘンニユズルノキュウジノツクリ
禹	チュウゴクノデンセツノオウノウ
禺	グウ，グウゼンノグウノツクリ
禽	モウキンルイ ノ キン
禾	ノギヘン ノ ノギ，カ
禿	ハゲヤマ ノ ハゲ
秀	シュウサイ ノ シュウ，ヒイデル
私	シテツ ノ シ，ワタシ
秉	コクモツノタンイヘイ
秋	アキマツリ ノ アキ，シュウ
科	キョウカショ ノ カ
秒	ビョウヨミ ノ ビョウ
秕	シイナ，ノギヘンニヒカクスルノヒ
秘	ヒミツ ノ ヒ
租	ソゼイ ノ ソ
秡	ハツ、ノギヘンニハライキヨメルノハライノツクリ
秣	リョウマツノマツ
秤	テンビン ノ ビン，ハカリ
秦	シン ノ シコウテイ ノ シン
秧	オウ，ノギヘンニチュウオウシュウケンノオウ
秩	チツジョ ノ チツ
秬	キョ、ノギヘンニキョダイナノキョ
称	イチニンショウ ノ ショウ
移	イドウ ノ イ，ウツル
稀	マレ，ノギヘン ニ キボウ ノ キ
稈	ムギワラヲイミスルバッカンノカン
程	ニッテイ ノ テイ，ホド
稍	ショウ，ノギヘンニショウゾウガノショウ
税	ゼイキン ノ ゼイ
稔	ミノル，ノギヘン ニ ザンネン ノ ネン
稗	ショクブツ ノ ヒエ
稘	キ，ノギヘンニソノ
稙	チョク，ノギヘンニチョクゼンノチョク
稚	ヨウチエン ノ チ
稜	ヤマ ノ リョウセン ノ リョウ
稟	リンギショノリン
稠	チュウミツナノチュウ
種	シュルイ ノ シュ，タネ
稱	イチニンショウノショウノキュウジ
稲	イネ，イナサク ノ イナ
稷	シャショクノシンノショク，ノギヘン
稻	イネノキュウジ
稼	カセグ，カ
稽	ケイコスル
稾	ゲンコウヨウシノコウノイタイジ
稿	ゲンコウヨウシ ノ コウ
穀	コクモツ ノ コク
穂	イナホ ノ ホ
穃	ヨウ，ノギヘンニヨウセキノヨウ
穆	ノギヘン ノ ボク
穉	ヨウチエンノチノイタイジ
積	メンセキ ノ セキ，ツモル
穎	スグレルヲ イミスル エイ，ホサキ，ノギヘン
穏	ヘイオン ノ オン，オダヤカ
穐	アキ，ノギヘン ニ カメ
穗	イナホノホノキュウジ
穡	ショク，ノギヘンニリンショクノショク
穢	ケガレ，ワイ
穣	ゴコクホウジョウ ノ ジョウ
穩	ヘイオンノオン，オダヤカノキュウジ
穫	シュウカクスル ノ カク，トリイレル
穰	ゴコクホウジョウノジョウノキュウジ
穴	アナヲホル ノ アナ
究	ケンキュウ ノ キュウ
穹	ソウキュウノキュウ，アナカンムリニユミ
空	クウキ ノ クウ，ソラ
穽	オトシアナヲイミスルカンセイノセイ
穿	ウガツ，センコウスル ノ セン
突	ショウトツスル ノ トツ，ツク
窃	セットウハン ノ セツ
窄	シヤキョウサク ノ サク，スボマル
窈	ヨウチョウタルビジンノヨウ，アナカンムリニオサナイ
窒	チッソ ノ チツ
窓	マドグチ ノ マド，ソウ
窕	ヨウチョウタルビジンノチョウ，アナカンムリニイッチョウエンノチョウ
窖	コウ，アナカンムリニツゲル
窗	マドノイタイジ
窘	タシナメル，キン
窟	ドウクツ ノ クツ
窩	カ，アナカンムリニナベノツクリ
窪	クボム，クボチ ノ クボ
窮	キュウクツ ノ キュウ，キワマル
窯	カマモト ノ カマ，ヨウ
窰	カマモトノカマノイタイジ
窶	ヤツレル，ク
窺	アナカンムリ ノ ウカガウ
窿	リュウ，アナカンムリニリュウキスルノリュウノキュウジ
竃	カマド
竄	カイザンスルノザン，アナカンムリニネズミ
竅	キョウ，アナカンムリニシゲキノゲキノツクリ
竇	トウ，アナカンムリニハンバイノバイノキュウジ
竈	カマド
竊	セットウハンノセツノキュウジ
立	ドクリツ ノ リツ，タツ
竍	リョウノタンイノデカリットル
竏	リョウノタンイノキロリットル
竒	キミョウナノキノイタイジ
竓	リョウノタンイノミリリットル
竕	リョウノタンイノデシリットル
站	ヘイタンセンノタン
竚	チョ，タツヘンニウカンムリニイッチョウメノチョウ
竜	キョウリュウ ノ リュウ，タツ
竝	ナラブノキュウジ
竟	ヒッキョウノキョウ
章	ブンショウヲヨム ノ ショウ
竡	リョウノタンイノヘクトリットル
竢	シ，タツヘンニアイサツノアイノツクリ
竣	シュンコウシキ ノ シュン
童	グリムドウワ ノ ドウ
竦	スクム，ショウ
竪	タテゴト ノ タテ
竭	ケツ，タツヘンニカッショクノカツノツクリ
端	タンマツ ノ タン，ハシ
竰	リョウノタンイノセンチリットル
競	キョウソウスル ノ キョウ，キソウ
竸	キョウソウスルノキョウ，キソウノイタイジ
竹	タケ，ショウチクバイ ノ チク
竺	テンジク ノ ジク
竿	サオダケ ノ サオ，カン
笂	ウツボ，タケカンムリニヒノマルノマル
笄	コウガイ，ケイ，タケカンムリニトリイ
笆	ハ，タケカンムリニトモエ
笈	オイ，タケカンムリ ニ オヨブ
笊	ザル
笋	タケノコ，ジュンノイタイジ
笏	コツ，クゲノモツシャク
笑	エガオ ノ エ，ワラウ
笘	チョウ，タケカンムリニドクセンスルノセン
笙	フエノショウ
笛	フエヲフク ノ フエ
笞	ムチ，タケカンムリニダイドコロノダイ
笠	ハナガサ ノ カサ
笥	タンス ノ ス
符	ギモンフ ノ フ
笨	ホン，タケカンムリニホンモノノホン
第	ダイイチインショウ ノ ダイ
笳	カ，アシブエ，タケカンムリニカソクドノカ
笵	ハン，タケカンムリニカワガハンランスルノハン
笶	シ，タケカンムリニユミヤノヤ
笹	ショクブツ ノ ササ
筅	チャセンノセン，タケカンムリニイキサキノサキ
筆	フデバコ ノ フデ，ヒツ
筈	テハズ ノ ハズ
等	イットウショウ ノ トウ，ヒトシイ
筋	キンニク ノ キン，スジ
筌	チャセンノセン，タケカンムリニゼンコクノゼン
筍	タケノコ，ジュン
筏	イカダ
筐	キョウタイノキョウ，ハコ
筑	チクゼンニ ノ チク
筒	ツツ，スイトウ ノ トウ
答	コタエ，トウアン ノ トウ
策	サクリャク ノ サク
筝	ソウキョクノソウ，コトノイタイジ
筥	ロ，タケカンムリニオフロノロ
筧	カケヒ，タケカンムリニケンブツスルノケン
筬	セイ，オサ，タケカンムリニセイリツスルノセイ
筮	ゼイチクノゼイ
筰	サク，タケカンムリニサクブンノサク
筱	ジョウ，シノダケノシノノイタイジ
筴	キョウ，タケカンムリニセマイノキュウジノツクリ
筵	エン，ムシロ，タケカンムリニエンキスルノエン
筺	キョウタイノキョウ，ハコノイタイジ
箆	ヘラ
箇	カジョウガキ ノ カ
箋	ショホウセンノセン
箍	タガガハズレルノタガ
箏	ソウキョクノソウ，コト
箒	ソウ，ホウキ，タケカンムリニソウジキノソウノツクリ
箔	アルミハク ノ ハク
箕	ノウグ ノ ミ，タケカンムリ ニ ソ
算	サンスウ ノ サン
箘	キン，タケカンムリニクニガマエノナカニノギヘンノノギ
箙	フク，エビラ，タケカンムリニヨウフクノフク
箚	トウ，タケカンムリニゴウカカクノゴウニリットウ
箜	ク，タケカンムリニソラ
箝	カンコウレイノカン
箟	キン，タケカンムリニコンチュウノコン
管	カンリスル ノ カン
箪	タンス ノ タン
箭	セン，タケカンムリ ニ マエ
箱	ハコニツメル ノ ハコ
箴	シン，タケカンムリニハリキュウノハリノツクリ
箸	ハシオキ ノ ハシ
節	キセツ ノ セツ，フシ
篁	コウ，タカムラ，タケカンムリニコウタイシノコウ
範	モハン ノ ハン
篆	テンコクノテン
篇	タケカンムリ ノ ヘンシュウスル ノ ヘン
築	ケンチク ノ チク，キズク
篋	キョウ，タケカンムリニハコガマエノナカニセマイノキュウジノツクリ
篌	コウ，タケカンムリニオウコウキゾクノコウ
篏	ハメキザイクノハメル，カンノイタイジ
篝	コウ，カガリビノカガリ
篠	シノダケ ノ シノ
篤	キトクジョウタイ ノ トク
篥	ヒチリキノリキ，タケカンムリニクリノキノクリ
篦	ヘラ
篩	フルイニカケルノフルイ
篭	カゴ ノ イタイジ，タケカンムリ ニ キョウリュウ ノ リュウ
篳	ヒチリキノヒチ，タケカンムリニヒッキョウノヒツ
篶	エン，タケカンムリニシュウエンノチノエン
篷	ホウ，トマ，タケカンムリニダンジョノアイビキノアイ
簀	スノコノス
簇	ソウ，ムラガル，タケカンムリニスイゾクカンノゾク
簍	ロウ，タケカンムリニロウカクノロウノキュウジノツクリ
簑	ミノノイタイジ，タケカンムリニオトロエル
簒	サンダツスルノサン，ウバウ
簓	ササラ
簔	ミノノイタイジ，タケカンムリニオトロエルノヘンケイ
簗	サカナヲトルヤナ，タケカンムリニリョウザンパクノリョウ
簟	テン，タカムシロ，タケカンムリニニシノシタニハヤオキノハヤイ
簡	カンタンナ ノ カン
簣	キ，タケカンムリニキチョウヒンノキ
簧	コウ，タケカンムリニキイロノキノキュウジ
簪	カンザシ，シン
簫	ショウ，タケカンムリニゲンシュクナノシュクノキュウジ
簷	エン、タケカンムリニタンニンノタンノキュウジノツクリ
簸	ハ，タケカンムリ ニ ソノタ ノ ソニ カワ
簽	セン，タケカンムリニシケンヲウケルノケンノキュウジノツクリ
簾	スダレ，レン
簿	メイボ ノ ボ
籀	チュウ，タケカンムリニテヘントリュウガクセイノシュウ
籃	ヨウランキノラン
籌	チュウ，タケカンムリニコトブキノキュウジ
籍	コクセキ ノ セキ
籏	ハタ，タケカンムリニハタヲフルノハタ
籐	トウイスノトウ
籔	ス，タケカンムリニカズノキュウジ
籖	クジビキノクジ，センノイタイジ
籘	トウイスノトウノイタイジ
籟	ライ，タケカンムリニイライスルノライノキュウジ
籠	ロウジョウスルノロウ，カゴ
籤	クジビキノクジ，セン
籥	ヤク，タケカンムリニブシュノヤク
籬	リ，マガキ
米	コメ，シンマイ ノ マイ
籵	ナガサノタンイノデカメートル
籾	モミガラ ノ モミ
粁	キョリ ノ タンイ ノ キロメートル
粂	クメ，ヒサシイ ノ シタニ コメ
粃	シイナ，コメヘンニヒカクスルノヒ
粉	フンマツ ノ フン，コナ
粋	ジュンスイナ ノ スイ，イキ
粍	ナガサ ノ タンイ ノ ミリメートル
粐	ヌカ，コメヘンニトジマリノト
粒	ツブ，リュウシ ノ リュウ
粕	サケカス ノ カス，コメヘン ニ シロ
粗	ソマツナ ノ ソ，アライ
粘	ネバル，ネンド ノ ネン
粛	ゲンシュクナ ノ シュク
粟	キビアワ ノ アワ
粡	トウ，コメヘンニオナジ
粢	シトギ，モクジノジノシタニコメ
粤	チュウゴクカントンショウヲイミスルエツ
粥	オカユ ノ カユ
粧	オケショウ ノ ショウ
粨	ナガサノタンイノヘクトメートル
粫	ウルチ，コメヘンニケイジジョウノジ
粭	スクモ，コメヘンニゴウカクノゴウ
粮	ショクリョウノリョウ，カテノイタイジ
粱	リョウ，リョウザンパクノリョウノキノカワリニコメ
粲	サン，サンゼントカガヤクノサンノツクリ
粳	ウルチマイノウルチ
粹	ジュンスイナノスイノキュウジ
粽	ソウ，チマキ
精	セイシンテキ ノ セイ
糀	コウジ，コメヘンニハナビノハナ
糂	サン，コメヘンニハナハダシイ
糅	ジュウ，コメヘンニジュウドウノジュウ
糊	ノリヅケ ノ ノリ，コ
糎	ナガサ ノ タンイ ノ センチメートル
糒	ヒ，ホシイイ，コメヘンニジュンビスルノビノツクリ
糖	ブドウトウ ノ トウ
糘	スクモ，コメヘンニイエ
糜	ビランノビ
糞	フンニョウ ノ フン，クソ
糟	カス，ソウコウ ノ ツマ ノ ソウ
糠	ヌカヅケ ノ ヌカ
糢	アイマイモコノモ，コメヘンニバクダイナノバク
糧	ショクリョウ ノ リョウ，カテ
糯	モチゴメ，コメヘンニヒツジュヒンノジュ
糲	レイ，コメヘンニハゲムノキュウジノヒダリガワ
糴	テキ，カイヨネ
糶	チョウ，ウリヨネ
糸	ケイト ノ イト，シ
糺	キュウダンスルノキュウ，イトヘンニフダノツクリ
系	タイヨウケイ ノ ケイ
糾	フンキュウスル ノ キュウ
紀	キゲンゼン ノ キ
紂	インノチュウオウノチュウ，イトヘンニスンポウノスン
約	ヤクソク ノ ヤク
紅	コウチャ ノ コウ，ベニ
紆	ウヨキョクセツノウ
紊	ブン，フウキビンランノビン
紋	モンショウ ノ モン
納	ノウゼイ ノ ノウ，オサメル
紐	コシヒモ ノ ヒモ
純	ジュンスイ ノ ジュン
紕	ヒ，イトヘンニヒカクスルノヒ
紗	オリモノ ノ シャ，イトヘン ニ スクナイ
紘	ハッコウイチウ ノ コウ
紙	ガヨウシ ノ シ，カミ
級	サイコウキュウ ノ キュウ
紛	フンシツスル ノ フン，マギレル
紜	ウン，イトヘンニデンセツノデンノツクリ
素	ソシツ ノ ソ
紡	ボウセキ ノ ボウ，ツムグ
索	サクイン ノ サク
紫	シガイセン ノ シ，ムラサキ
紬	ツムギ，イトヘン ニ リユウ ノ ユウ
紮	ケッサツノサツ，ナフダノフダノシタニイト
累	ルイセキスル ノ ルイ
細	ホソイフトイ ノ ホソイ，サイ
紲	セツ，イトヘンニセカイノセ
紳	シンシテキナ ノ シン
紵	チョ，イトヘンニチョキンノチョノツクリ
紹	ジコショウカイ ノ ショウ
紺	コンイロ ノ コン
紿	タイ，イトヘンニダイドコロノダイ
終	シュウギョウシキ ノ シュウ，オワル
絃	ゲン，イトヘン ニ ゲンマイ ノ ゲン
組	クミ，ソシキ ノ ソ
絅	ケイ，イトヘンニコウジョウシンノコウカラテンヲトッタモノ
絆	バンソウコウノバン，キズナ
絋	イトヘンニヒロバノヒロ
経	ケイケンスル ノ ケイ
絎	コウ，イトヘンニリョコウスルノコウ
絏	セツ，イトヘンニエイコウダンノエイ
結	ケツロン ノ ケツ
絖	コウ，イトヘンニヒカリ
絛	ジョウ，ジョウケンノジョウノキュウジノキノカワリニイト
絞	シボル，コウシュケイ ノ コウ
絡	レンラクスル ノ ラク，カラム
絢	ケンランゴウカ ノ ケン
絣	カスリノキモノノカスリ
給	キュウショクシツ ノ キュウ
絨	ソラトブジュウタンノジュウ
絮	リュウジョノジョ，ワタ
統	トウイツ ノ トウ
絲	ケイトノイトノキュウジ，イトフタツ
絳	コウ，イトヘンニコウスイリョウノコウノツクリ
絵	エホン ノ エ
絶	ゼッタイテキ ノ ゼツ
絹	キヌイト ノ キヌ
絽	ロノキモノノロ
綉	シシュウスルノシュウノイタイジ
綏	スイゼイテンノウノスイ
經	ケイケンスルノケイノキュウジ
継	ケイゾクスル ノ ケイ，ツグ
続	レンゾク ノ ゾク，ツヅク
綛	カスリ，イトヘンニシノビ
綜	サクソウスル ノ ソウ，イトヘン ニ シュウキョウ ノ シュウ
綟	レイ，イトヘンニモドル
綢	チュウ，イトヘンニシュウヘンノシュウノキュウジタイ
綣	ケン，イトヘンニノリマキノマキノキュウジ
綫	シンカンセンノセンノイタイジ
綬	シジュホウショウ ノ ジュ，イトヘン ニ ウケル
維	イジスル ノ イ
綮	ケイ，ケイハツノケイノクチノカワリニイト
綯	ナワヲナウノナウ
綰	ワン，イトヘンニケイサツカンノカン
綱	ツナヒキ ノ ツナ，コウ
網	モウマク ノ モウ，アミ
綴	ツヅル
綵	サイ，イトヘンニハクシュカッサイノサイノキュウジタイ
綸	リンゲンアセノゴトシノリン
綺	キレイナノキ，イトヘンニキミョウナノキ
綻	ハタンスル ノ タン，ホコロビル
綽	ヨユウシャクシャクノシャク
綾	アヤオリ ノ アヤ
綿	ワタ，モメン ノ メン
緇	シ，イトヘンニシチョウヘイノシノツクリ
緊	キンキュウ ノ キン
緋	ヒイロ ノ ヒ
総	ソウリダイジン ノ ソウ
緑	ミドリ，リョクチャ ノ リョク
緒	ナイショ ノ ショ
緕	シ，イトヘンニイッセイシャゲキノセイ
緘	カンモクノカン，イトヘンニシンノミヤコカンヨウノカン，
線	センロ ノ セン
緜	モメンノメンノイタイジ
緝	シュウ，イトヘンニクチノシタニミミ
緞	ドンスノドン，イトヘンニネダンノダン
締	テイケツスル ノ テイ，シメル
緡	ビン，イトヘンニタミノシタニマイニチノニチ
緤	セツ，イトヘンニシャベルノツクリ
編	ヘンシュウスル ノ ヘン，アム
緩	ユルヤカ，カンワスル ノ カン
緬	チリメン ノ メン
緯	イドケイド ノ イ
緲	ビョウ，イトヘンニモクテキノモクニスクナイ
練	レンシュウ ノ レン
緻	チミツナノチ
縁	エンガワ ノ エン，フチ
縄	ナワ，ジョウモンドキ ノ ジョウ
縅	ヨロイノオドシ，イトヘンニイカクスルノイ
縉	シン，イトヘンニチュウゴクノコクメイノシン，ススムノキュウジ
縊	イシスルノイ，クビル
縋	スガリツクノスガル，ツイ，イトヘンニツイセキスルノツイ
縒	ヨリヲモドスノヨリ，イトヘンニサベツカノサ
縛	シバル，ソクバク ノ バク
縞	シマモヨウ ノ シマ
縟	ジョク，イトヘンニブジョクスルノジョク
縡	サイ，イトヘンニテッケツサイショウノサイ
縢	イトカガリノカガル，トウ
縣	トドウフケンノケンノキュウジ
縦	タテヨコ ノ タテ，ジュウ
縫	サイホウスル ノ ホウ，ヌウ
縮	タンシュク ノ シュク，チヂム
縱	ジュウ，タテヨコノタテノキュウジ
縲	ルイ，イトヘンニルイセキスルノルイ
縵	マン，イトヘンニマンダラノマン
縷	イチルノノゾミノル
縹	ヒョウ，ハナダ，イトヘンニトウヒョウスルノヒョウ
縺	レン，モツレル
縻	キビセイサクノビ
總	ソウリダイジンノソウノキュウジ
績	セイセキヒョウ ノ セキ
繁	ハンエイスル ノ ハン，シゲル
繃	ホウタイヲマクノホウ，イトヘンニクズレル
繆	ビュウ，イトヘンニニカワノツクリ
繊	カガクセンイ ノ セン
繋	ケイリュウスル ノ ケイ，ツナグ
繍	シシュウスル ノ シュウ
織	ソシキ ノ シキ
繕	シュウゼンスル ノ ゼン，ツクロウ
繖	サン，イトヘンニサンポミチノサン
繙	ハン，ヒモトク
繚	リョウランノリョウ，イトヘンニドウリョウノリョウノツクリ
繝	ゲン，イトヘンニアイダノキュウジ
繞	カンジブシュノニョウ，イトヘンニギョウシュンノギョウノキュウジ
繦	スキ，キョウ，イトヘンニユミニイエドモノヒダリガワ
繧	ウン，イトヘンニクモユキノクモ
繩	ジョウモンドキノジョウノキュウジ
繪	カイガノカイ，エホンノエノキュウジ
繭	マユ，カイコ ノ マユ
繰	クル，クリカエシ ノ クリ
繹	エンエキホウノエキ
繻	オリモノノシュスノシュ
繼	ナマチュウケイノケイノキュウジ
繽	ヒン，イトヘンニライヒンノヒン
繿	ラン，イトヘンニエイガカントクノカン
纂	ジショヲヘンサンスル ノ サン
纃	シ，イトヘンニイッセイシャゲキノセイノキュウジ
纈	コウケチゾメノケチ
纉	サン，イトヘンニサンセイスルノサン
續	レンゾクノゾク，ツヅクノキュウジ
纎	カガクセンイノセンノキュウジノイタイジ
纏	ハンテン ノ テン，マトウ
纐	コウケチゾメノコウ
纒	ハンテンノテン，マトウノイタイジ
纓	エイ，イトヘンニサクラノキュウジノツクリ
纔	ワズカヲイミスルイトヘンノサイ
纖	カガクセンイノセンノキュウジ
纛	トク，ドクヤクノドクノシタニトドウフケンノケンノキュウジ
纜	ラン，イトヘンニハクランカイノランノキュウジ
缶	カンヅメ ノ カン
缸	コウ，ホトギヘンニズガコウサクノコウ
缺	ホケツノケツ，カケルノキュウジ
罅	ヒビワレルノヒビ，カ
罌	オウ，カイガラノカイフタツノシタニホトギ
罍	ライ，タハタノタミッツノシタニホトギ
罎	アキビンノビン，ホトギヘンニクモリ
罐	カンヅメノカンノキュウジ
网	ボウ，ブシュノアミガシラ
罔	モウ，モウマクノモウノツクリ
罕	トリアミヲイミスルカン
罘	フウ，アミガシラニフシギノフ
罟	コ，アミガシラニチュウコシャノコ
罠	ワナ，アミガシラニタミ
罧	シノヅケ，アミガシラニミツリンノリン
罨	アンポウノアン
罩	トウ，アミガシラニタッキュウノタク
罪	ハンザイ ノ ザイ，ツミ
罫	ケイセンヲヒク ノ ケイ
置	ソウチ ノ チ，オク
罰	ツミトバツ ノ バツ
署	ショメイスル ノ ショ
罵	バセイ ノ バ，ノノシル
罷	ヒメンスル ノ ヒ
罸	ツミトバツノバツノイタイジ
罹	リカンスルノリ，カカル
羂	ケン，アミガシラニキヌイトノキヌ
羃	ベキ，アミガシラニジマクノマク
羅	モウラスル ノ ラ
羆	ヒグマ，アミガシラニクマ
羇	キ，アミガシラニカクメイノカクニキミョウナノキ
羈	キビセイサクノキ
羊	ヨウモウ ノ ヨウ，ヒツジ
羌	チュウゴクホクセイブミンゾクノヒトツ，キョウ，ヒツジノシタニヒトアシ
美	ビジン ノ ビ，ウツクシイ
羔	コウ，コヒツジ，ヒツジノシタニレンガ
羚	レイ，ヒツジヘンニメイレイスルノレイ
羝	テイ，オヒツジ，ヒツジヘンニテイコウスルノテイノツクリ
羞	シュウチシンノシュウ
羣	グンシュウノグン，ムレルノイタイジ
群	グンシュウ ノ グン，ムレ
羨	センボウスル ノ セン，ウラヤム
義	ギム ノ ギ
羮	ミズヨウカンノカン，アツモノノイタイジ
羯	ガッキノカッコノカツ
羲	チュウゴクノデンセツジョウノテンシ，フクギノギ
羶	セン，ヒツジヘンニブツダンノダンノツクリ
羸	ルイジャクノルイ
羹	ミズヨウカンノカン，アツモノ
羽	ハネ，ウモウ ノ ウ
翁	オキナ，オウ
翅	シ，ササエルノミギニウモウノウ
翆	ヒスイノスイノイタイジ
翊	ヨク，ドクリツノリツノミギニウモウノウ
翌	ヨクジツ ノ ヨク
習	レンシュウ ノ シュウ，ナラウ
翔	ヒショウスルノショウ，カケル，ヒツジニウモウノウ
翕	キュウ，ゴウカクスルノゴウニウモウノウ
翠	ヒスイ ノ スイ
翡	ヒスイノヒ，ヒジョウグチノヒノシタニウモウノウ
翦	セン，マエウシロノマエノシタニウモウノウ
翩	ヘンポントヒルガエルノヘン
翫	ガン，レンシュウ ノ シュウ ニ ゲンキ ノ ゲン
翰	ショカンヲ オクル ノ カン，シンカンセン ノ カン ノ ホス ノ カワリニ ウモウ ノ ウ
翳	カゲリ，エイ，オイシャサンノイニルマタ，ソノシタニウモウノウ
翹	ギョウ，ギョウシュンノギョウノキュウジニウモウノウ
翻	ホンヤクスル ノ ホン
翼	ツバサ，ビヨク ノ ヨク
耀	エイヨウエイガ ノ ヨウ，カガヤク
老	ロウジン ノ ロウ
考	カンガエル，サンコウショ ノ コウ
耄	モウロクスルノモウ，ロウジンノロウノシタニケイトノケ
者	ガクシャ ノ シャ，モノ
耆	キ，ロウジンノロウノシタニマイニチノニチ
耋	テツ，ロウジンノロウノシタニダイシキュウノシ，
而	シコウシテ，ケイジジョウ ノ ジ
耐	ニンタイ ノ タイ，タエル
耒	ライ，ブシュノスキヘン
耕	タガヤス，ノウコウ ノ コウ
耗	ショウモウヒン ノ モウ
耘	コウウンキノウン，ブシュノスキヘンニウンヌンノウン
耙	ハ，スキヘンニトモエ
耜	シ，スキヘンニケイサツカンノカンノシタガワ
耡	ジョ，スキヘンニキュウジョスルノジョ
耨	ドウ，スキヘンニブジョクスルノジョク
耳	ミミ，ジビカ ノ ジ
耶	ウヤムヤ ノ ヤ
耻	ハジヲカクノハジノイタイジ
耽	タンデキスル ノ タン，フケル
耿	コウ，ミミヘンニカヨウビノカ
聆	レイ，ミミヘンニメイレイスルノレイ
聊	ブリョウヲカコツノリョウ
聒	カツ，ミミヘンニシタヲカムノシタ
聖	セイカリレー ノ セイ
聘	ショウヘイスルノヘイ
聚	ジュラクダイノジュ
聞	シンブン ノ ブン，キコエル
聟	ムコノイタイジ，ツウチヒョウノチノシタニミミ
聡	ソウメイナ ノ ソウ，サトイ
聢	シカト，ミミヘンニサダメル
聨	ミミヘンノレンゴウノレンノイタイジ
聯	ミミヘン ノ レンゴウ ノ レン
聰	ソウメイナノソウノキュウジ
聲	オンセイノセイ，コエノキュウジ
聳	ソビエル
聴	チョウカク ノ チョウ，キク
聶	ジョウ，ミミミッツ
職	ショクギョウ ノ ショク
聹	ネイ，ミミヘンニテイネイノネイ
聽	ホチョウキノチョウノキュウジ
聾	ロウガッコウ ノ ロウ
聿	イツ，ブシュノフデヅクリ
肄	イ，ギモンノギノヒダリガワニフデヅクリ
肅	ゲンシュクナノシュクノキュウジ
肆	シ，ケイヤクショニツカウスウジノヨン
肇	クニヲハジメル ノ ハジメ，チョウ
肉	ギュウニク ノ ニク
肋	ロクマクエン ノ ロク
肌	ハダイロ ノ ハダ
肓	ヤマイコウコウノウシロノコウ
肖	ショウゾウガ ノ ショウ
肘	ヒジ，ニクヅキニスンポウ ノ スン
肚	ズ，ニクヅキニドヨウビノド
肛	オシリノコウモンノコウ
肝	カンゾウ ノ カン，キモ
股	コカンセツ ノ コ，マタ
肢	センタクシ ノ シ
肥	ヒマン ノ ヒ，コエル
肩	カタコリ ノ カタ，ケン
肪	シボウブン ノ ボウ
肬	イボ，ユウ，ニクヅキニモットモ
肭	ドツ，ニクヅキニコクナイノナイ
肯	コウテイヒテイ ノ コウ
肱	ココウノシン ノ コウ，ヒジ
育	キョウイク ノ イク，ソダテル
肴	シュコウ ノ コウ，サカナ
肺	ハイカツリョウ ノ ハイ
胃	イブクロ ノ イ
胄	チュウ，リユウノユウノシタニニクヅキ
胆	ダイタンナ ノ タン
背	セボネ ノ セ
胎	ジュタイスル ノ ジュ
胖	ハン，ニクヅキニハンブンノハン
胙	ソ，ニクヅキニムカシナガラノナガラ
胚	ハイガマイノハイ
胛	コウ，ニクヅキニコウオツノコウ
胝	チ，ニクヅキニテイコウスルノテイノツクリ
胞	サイボウ ノ ボウ
胡	クロコショウ ノ コ
胤	ゴラクイン ノ イン，タネ
胥	ショ，オリモノノタンイノヒキノシタニニクヅキ
胯	コ，ニクヅキニハカマノツクリ
胱	ボウコウエンノコウ
胴	ドウアゲ ノ ドウ
胸	キョウイ ノ キョウ，ムネ
胼	ヘイ，ニクヅキニヘイゴウスルノヘイノツクリ
能	サイノウ ノ ノウ
脂	シボウ ノ シ，アブラ
脅	キョウハク ノ キョウ，オドス
脆	ゼイジャクナ ノ ゼイ，モロイ
脇	ワキヤク ノ ワキ
脈	サンミャク ノ ミャク
脉	サンミャクノミャクノイタイジ，ニクヅキニエイキュウノエイ
脊	セキズイ ノ セキ
脚	キャクホン ノ キャク，アシ
脛	ケイ，スネ，ニクヅキニケイツイノケイノヒダリガワ
脣	シン，クチビル，ジュウニシノタツノシタニニクヅキ
脩	ソクシュウヲオサメルノシュウ
脯	ホ，ニクヅキニシジンノトホノホ
脱	ヌグ，ダツボウ ノ ダツ
脳	ズノウ ノ ノウ
脹	ボウチョウスル ノ チョウ，ニクヅキニナガイ
脾	ゾウキノヒゾウノヒ
腆	テン，ニクヅキニコクゴジテンノテン
腋	エキ，ワキ，ニクヅキニヨルヒルノヨル
腎	ジンゾウビョウ ノ ジン
腐	クサル，フハイスル ノ フ
腑	フヌケノフ
腓	ヒコツノヒ，コムラ
腔	コウクウゲカ ノ クウ，ニクヅキニソラ
腕	ウデ，ワンリョク ノ ワン
腟	チツ，ニクヅキニキョウシツノシツ
腥	セイ，ニクヅキニワクセイノセイ
腦	ズノウメイセキノノウノキュウジ
腫	シュヨウ ノ シュ，ハレル
腮	エラ，ニクヅキニシアンガオノシ
腰	ヨウツウ ノ ヨウ，コシ
腱	アキレスケンノケン
腴	ユ，ニクヅキニシュユノマノユ
腸	ダイチョウ，ショウチョウ ノ チョウ
腹	ハラペコ ノ ハラ，フク
腺	コウジョウセン ノ セン
腿	ダイタイコツ ノ タイ，モモ
膀	ボウコウエンノボウ
膂	リョ，リョヒノリョノシタニニクヅキ
膃	オットセイノオツ
膈	カク，ニクヅキニヘダテルノツクリ
膊	ジョウハクコツノハク
膏	ナンコウヲヌル ノ コウ
膓	チョクチョウノチョウノイタイジ，ニクヅキニキリキズノキズノツクリ
膕	カク，ニクヅキニユキグニノクニノキュウジ
膚	ヒフ ノ フ，ハダ
膜	モウマク ノ マク
膝	ヒザマクラ ノ ヒザ
膠	コウゲンビョウノコウ，ニカワ
膣	チツ，ニクヅキニチッソノチツ
膤	ユキ，ニクヅキニユキグニノユキ
膨	ボウチョウスル ノ ボウ，フクラム
膩	ジ，ニクヅキニケイヤクショニツカウカンスウジノニノキュウジ
膰	ハン，ニクヅキニバンゴウノバン
膳	アゲゼンスエゼン ノ ゼン
膵	スイゾウノスイ
膸	セキズイノズイノイタイジ
膺	ケンケンフクヨウノヨウ
膽	ダイタンナノタンノキュウジ
膾	ジンコウニカイシャスルノカイ，ナマス
膿	カノウスル ノ ノウ，ウミ
臀	シリヲイミスルデンブノデン
臂	ハチメンロッピノヒ，ヒジ
臆	オクビョウナ ノ オク
臈	ロウ，ニクヅキニクズモチノクズ
臉	セン，ニクヅキニマブタノツクリ
臍	セイカタンデンノセイ，ヘソ
臑	ジュ，ニクヅキニジュヨウトキョウキュウノジュ
臓	シンゾウカンゾウ ノ ゾウ
臘	ロウ，ニクヅキニリョウジュウノリョウノキュウジノツクリ
臙	エン，ニクヅキニツバメ
臚	ロ，ニクヅキニハゼノキノハゼノツクリ
臟	ゴゾウロップノゾウノイタイジ
臠	レン，コイビトノコイノキュウジノココロノカワリニニク
臣	ソウリダイジン ノ ジン
臥	フス，ガシンショウタン ノ ガ
臧	ゾウ，レイゾウコノゾウノイタイジカラクサカンムリヲトッタカタチ
臨	リンジ ノ リン
自	ジテンシャ ノ ジ，ミズカラ
臭	クサイ，アクシュウ
至	シキュウ ノ シ，イタル
致	イッチスル ノ チ，イタス
臺	ダイドコロノダイノキュウジ
臻	シン，ブシュノイタルニシンノシコウテイノシン
臼	ダッキュウスル ノ キュウ，ウス
臾	シュユノマノユ
舁	カゴヲカクノカク
舂	ウスヅク，ショウ
舅	シュウト
與	アタエル，キュウヨノヨノキュウジ
興	キョウミ ノ キョウ
舉	センキョノキョ，アゲルノキュウジノイタイジ
舊	キュウレキノキュウノキュウジ
舌	シタヲカム ノ シタ
舍	ガッコウノコウシャノシャノキュウジ
舎	ガッコウ ノ コウシャ ノ シャ
舐	ナメル，シタヘンニウジガミノウジ
舒	ジョ，シュクシャノシャノキュウジノミギニヨテイノヨ
舖	ホソウドウロノホノキュウジ
舗	ホソウスル ノ ホ
舘	ヤカタ ノ イタイジ，カン
舛	ソムクヲ イミスル セン，マス
舜	ギョウシュン ノ シュン
舞	カブキ ノ ブ，マウ
舟	ゴエツドウシュウ ノ シュウ，フネ
舩	フネ，フネヘンニオオヤケ
航	コウクウキ ノ コウ
舫	モヤイムスビノモヤイ
般	イッパンテキ ノ ハン
舮	フネノトモ，フネヘンニトジマリノト
舳	フネノヘサキ，フネヘンニリユウノユウ
舵	カジ，ソウダシュ ノ ダ
舶	ハクライヒン ノ ハク
舷	ウゲンサゲン ノ ゲン，フナバタ
舸	カ，フネヘンニカノウセイノカ
船	フネ，センチョウ ノ セン
艀	ハシケ
艇	ヒコウテイ ノ テイ
艘	フネヲカゾエルタンイノソウ
艙	ソウ，フネヘンニカマクラバクフノクラ
艚	ソウ，フネヘンニソウトウシュウノソウ
艝	ソリ，フネヘンニユキグニノユキ
艟	トウ，フネヘンニグリムドウワノドウ
艢	ショウ，フネヘンニリンショクノショク
艤	ギ，フネヘンニギムノギ
艦	センスイカン ノ カン
艨	モウ，フネヘンニケイモウスルノモウ
艪	フナコギニツカウロ，フネヘンニロドンナノロ
艫	フネノトモ，フネヘンニハゼノキノハゼノツクリ
艮	ウシトラ ノ コン
良	カイリョウ ノ リョウ，ヨイ
艱	カンナンシンクノカン
色	イロエンピツ ノ イロ，ショク
艶	ヨウエンナ ノ エン，ツヤ
艷	ヨウエンナノエン，ツヤノキュウジ
艸	ソウ，ブシュノクサカンムリ
艾	モグサ，ガイ
芋	ヤキイモ ノ イモ
芍	ショクブツノシャクヤクノシャク
芒	ボウ、クサカンムリニボウメイスルノボウ
芙	ショクブツ ノ フヨウ ノ フ
芝	シバフ ノ シバ
芟	サン、クサカンムリニルマタ
芥	アクタガワショウ ノ アクタ
芦	アシ，クサカンムリ ニ トジマリ ノ ト
芫	ゲン、クサカンムリニゲンキナノゲン
芬	アクシュウフンプンノフン
芭	バショウ ノ バ
芯	エンピツ ノ シン ノ シン
花	ハナ，カビン ノ カ
芳	カンバシイ，ホウコウザイ ノ ホウ
芸	ゲイジュツ ノ ゲイ
芹	ショクブツ ノ セリ
芻	スウ、ハンスウドウブツノスウ
芽	ハツガ ノ ガ，キノメ ノ メ
苅	カル，クサカンムリ ノ カル
苑	ジングウガイエン ノ エン
苒	ゼン、フタタビノイッカクメノカワリニクサカンムリ
苓	レイ，クサカンムリ ニ メイレイ ノ レイ
苔	ショクブツ ノ コケ，タイ
苗	ナエギ ノ ナエ，ビョウ
苙	リュウ、クサカンムリニドクリツノリツ
苛	イラダツ，カコク ノ カ
苜	モク、クサカンムリニモクテキノモク
苞	ホウ、クサカンムリニツツム
苟	イヤシクモ、クサカンムリニハイクノク
苡	イ、クサカンムリニイジョウイカノイ
苣	キョ、クサカンムリニキョダイナノキョ
若	ワカモノ ノ ワカ
苦	クロウ ノ ク，クルシイ
苧	ショクブツ ノ カラムシ，チョ
苫	トマコマイシ ノ トマ
英	エイユウ ノ エイ
苳	トウ、クサカンムリニフユヤスミノフユ
苴	ショ、クサカンムリニクミノツクリ
苹	ヘイ、クサカンムリニヘイボンナノヘイ
苺	クダモノノイチゴ、クサカンムリニハハ
苻	フ、クサカンムリニフロクノフ
茂	ハンモ ノ モ，シゲル
范	ハン、クサカンムリニカワガハンランスルノハン
茄	クサカンムリ ニ クワエル ノ カ，ナス
茅	カヤブキ ノ カヤ
茆	ボウ、クサカンムリニジュウニシノウサギ
茉	マツ、クサカンムリニネンマツノマツ
茎	クキ，チカケイ ノ ケイ
茖	カク、クサカンムリニオノオノ
茗	ミョウガノミョウ，クサカンムリニナマエノナ
茘	クダモノノレイシノレイ，クサカンムリニカタナガミッツ
茜	アカネイロ ノ アカネ
茣	ゴザノゴ，クサカンムリニゴフクヤノゴノキュウジケイ
茨	イバラキケン ノ イバラ
茫	ボウゼンジシツノボウ，クサカンムリニサンズイニボウメイスルノボウ
茯	ブクリョウノブク，クサカンムリニキフクニトムノフク
茱	シュ，クサカンムリニシュイロノシュ
茲	シ、クサカンムリニイトガシラフタツ
茴	ウイキョウノウイ、クサカンムリニカイスウケンノカイ
茵	イン、クサカンムリニインガオウホウノイン
茶	チャイロ ノ チャ
茸	マツタケ ノ タケ，キノコ
茹	ジョ，ユデル，クサカンムリニトツジョノジョ
荀	ジュン，クサカンムリニゲジュンノジュン
荅	トウ，クサカンムリニゴウカクノゴウ
草	クサ，ソウゲン ノ ソウ
荊	クサカンムリ ニ ケイムショ ノ ケイ，イバラ
荏	エゴマ ノ エ
荐	セン，クサカンムリニソンザイスルノソン
荒	アレル，コウヤ ノ コウ
荘	ベッソウチ ノ ソウ
荳	トウ、マメ、クサカンムリニマメモチノマメ
荵	ニン、クサカンムリニニンジャノニン
荷	ニモツ ノ ニ
荻	オギ
荼	ダビニフスノダ
莅	リ，クサカンムリニタンイノイ
莇	ショ、クサカンムリニキュウジョスルノジョ
莉	リ、クサカンムリニリエキノリ
莊	ベッソウチノソウノイタイジ
莎	サ、クサカンムリニゴブサタノサ
莓	クダモノノイチゴ、クサカンムリニマイニチノマイ
莖	チカケイノケイノキュウジ
莚	エン，ムシロ，クサカンムリニエンキスルノエン
莞	クサカンムリ ニ カンリョウスル ノ カン
莟	カン，クサカンムリニフクメル
莠	ユウ，クサカンムリニヒイデル
莢	キョウ，マメノサヤ
莨	ロウ、タバコ、クサカンムリニカイリョウスルノリョウ
莪	ガ，クサカンムリニガマンノガ
莫	バクダイナ ノ バク
莱	ホウライサン ノ ライ
莵	ト，クサカンムリニウサギノイタイジ
莽	ソウモウノシンノモウ
菁	セイ、カブ、クサカンムリニセイシュンノセイノキュウジタイ
菅	スゲガサ ノ スゲ，カン
菊	キクニンギョウ ノ キク
菌	サッキンスル ノ キン
菎	コン、クサカンムリニコンチュウノコン
菓	オカシ ノ カ
菖	ハナショウブ ノ ショウ
菘	スズナ、クサカンムリニマツノキノマツ
菜	ヤサイ ノ サイ，ナ
菟	ト，クサカンムリ ニ ウサギ
菠	ハ、クサカンムリニハチョウガアウノハ
菩	ボダイジュ ノ ボ
菫	ショクブツノスミレ
華	ゴウカ ノ カ，ハナヤカ
菰	コモカブリ ノ コモ，クサカンムリ ニ コドク ノ コ
菱	ヒシガタ ノ ヒシ
菲	ヒ、クサカンムリニヒジョウグチノヒ
菴	アン，イオリ，クサカンムリニキソクエンエンノエン
菷	ソウ、ホウキ，クサカンムリニソウジキノソウノツクリ
菻	リン、クサカンムリニゾウキバヤシノハヤシ
菽	シュク、クサカンムリニシュクジョノシュクノツクリ
萃	スイ、クサカンムリニソツギョウノソツ
萄	ブドウシュ ノ ドウ
萇	チョウ、クサカンムリニチョウナンノチョウ
萋	セイ、クサカンムリニアイサイカノサイ
萌	ホウガ ノ ホウ，モエル
萍	ヘイ，クサカンムリニサンズイニヘイワノヘイ
萎	イシュクスル ノ イ，ナエル
萓	ギ、クサカンムリニベンギノギ
萠	ホウガノホウ，モエルノイタイジ
萢	ヤチ、クサカンムリニアワダテルノアワ
萩	ショクブツ ノ ハギ
萪	カ、クサカンムリニキョウカショノカ
萬	マンネンヒツノマン、ヨロズノキュウジ
萱	クサカンムリ ニ センデン ノ セン
萵	ワ，クサカンムリニナベノツクリ
萸	ユ、クサカンムリニシュユノマノユ
萼	ショクブツノハナノガク
落	ラクセンスル ノ ラク，オチル
葆	ホウ、クサカンムリニホアンノホ
葉	キノハ ノ ハ，ヨウ
葎	ショクブツ ノ ムグラ，クサカンムリ ニ ホウリツ ノ リツ
著	チョシャ ノ チョ，イチジルシイ
葛	カットウ ノ カツ，クズ
葡	ブドウシュ ノ ブ
葢	フタノイタイジ，クサカンムリニフトイニサラ
董	コットウヒン ノ トウ
葦	アシブエ ノ アシ
葩	ハ，クサカンムリニシロイノミギニトモエ
葫	コ、クサカンムリニミズウミノツクリ
葬	ソウシキ ノ ソウ，ホウムル
葭	カ、アシ、クサカンムリニヒマツブシノヒマノツクリ
葮	タン、クサカンムリニシュダンノダン
葯	ヤク，クサカンムリニヤクソクノヤク
葱	ショクブツ ノ ネギ
葵	アオイマツリ ノ アオイ
葷	クンシュサンモンニイルヲユルサズノクン
葹	シ，クサカンムリニホドコス
葺	ヤネヲフク ノ フク
蒂	タイ，クサカンムリニテイオウノテイ
蒄	カン、クサカンムリニゲッケイカンノカン
蒋	クサカンムリ ニ ショウグン ノ ショウ
蒐	クサカンムリ ニ オニ ノ シュウ
蒔	タネヲマク ノ マク
蒙	ケイモウスル ノ モウ
蒜	ショクブツ ノ ヒル
蒟	コンニャクノイチモジメ，クサカンムリニドクリツノリツ，ソノミギニハイクノク
蒡	キンピラゴボウノボウ
蒭	スウ，クサカンムリニハンスウスルノスウ
蒲	カバヤキ ノ カバ
蒸	ジョウキ ノ ジョウ，ムス
蒹	ケン，クサカンムリニカネル
蒻	コンニャクノニャク
蒼	ガンメンソウハク ノ ソウ，アオイ
蒿	コウ，クサカンムリニタカイヒクイノタカイ
蓁	シン，クサカンムリニシンノシコウテイノシン
蓄	チョチク ノ チク
蓆	セキ，クサカンムリニザセキノセキ
蓉	ショクブツ ノ フヨウ ノ ヨウ
蓊	オウ，クサカンムリニオキナ
蓋	ズガイコツ ノ ガイ，フタ
蓍	シ，クサカンムリニヒレノツクリ
蓐	ジョク，クサカンムリニブジョクスルノジョク
蓑	ミノムシ ノ ミノ
蓖	ヒマシユノヒ
蓙	ゴザノザ，クサカンムリニギンザノザ
蓚	シュウ，クサカンムリニシュウリスルノシュウ
蓬	ホウライサン ノ ホウ，ヨモギ
蓮	レンコン ノ レン，ハス
蓴	ジュンサイノジュン
蓼	タデクウムシモスキズキノタデ
蓿	シュク，クサカンムリニシュクダイノシュク
蔀	シトミ，クサカンムリ ニ ブチョウ ノ ブ
蔆	ヒシガタノヒシノイタイジ
蔑	ケイベツスル ノ ベツ，サゲスム
蔓	マンエンスル ノ マン，ツル
蔔	ホク，クサカンムリニホフクゼンシンノフク
蔕	タイ，クサカンムリニオビノキュウジ
蔗	ショトウノショ，クサカンムリニショミンノショ
蔘	シン，クサカンムリニサンギインノサンノキュウジ
蔚	クサカンムリ ニ リクグンタイイ ノ イ
蔟	ソク，クサカンムリニスイゾクカンノゾク
蔡	サイ，クサカンムリニシュクサイジツノサイ
蔦	ショクブツ ノ ツタ
蔬	ソサイルイノソ
蔭	クサカンムリ ノ カゲ
蔵	レイゾウコ ノ ゾウ
蔽	シャヘイスル ノ ヘイ
蕀	キョク，クサカンムリニキョクヒドウブツノキョク
蕁	ジンマシンノジン
蕃	バン，クサカンムリ ニ バンゴウ ノ バン
蕈	シン，クサカンムリニニシノシタニハヤオキノハヤイ
蕉	ミズバショウ ノ ショウ
蕊	メシベ ノ シベ，ズイ
蕋	メシベノシベ，ズイノイタイジ，クサカンムリニシケツスルノシミッツ
蕎	ショクブツ ノ ソバ，キョウ
蕕	ユウ，クサカンムリニユウヨスルノユウ
蕗	ショクブツ ノ フキ
蕘	ジョウ，クサカンムリニギョウシュンノギョウノキュウジ
蕚	ショクブツノハナノガクノイタイジ
蕣	シュン，クサカンムリニギョウシュンノシュン
蕨	ショクブツ ノ ワラビ
蕩	ホウトウムスコ ノ トウ
蕪	ヤサイ ノ カブ
蕭	ショウ，クサカンムリニゲンシュクナノシュクノキュウジ
蕷	ヨ，クサカンムリニアズケル
蕾	ツボミ，ライ，クサカンムリニカミナリ
薀	ウンチクヲカタムケルノウン，サンズイ
薄	ウスイ，ケイハク ノ ハク
薇	ビ，バライロノバラノニモジメ
薈	ワイ，クサカンムリニカイシャインノカイノキュウジ
薊	ショクブツノアザミ
薐	リョウ，クサカンムリニヤマノリョウセンノリョウ
薑	キョウ，クサカンムリニカシハラジングウノカシノツクリ
薔	ショウ，バライロノバラノイチモジメ
薗	ソノ，クサカンムリ ニ ガクエン ノ エン
薙	クサナギ ノ ナギ
薛	カワラヨモギヲイミスルセツ
薜	ヘイ，クサカンムリニカベノウエガワ
薤	ラッキョウ
薦	スイセンジョウ ノ セン，ススメル
薨	コウキョスルノコウ，ミマカル
薩	サツマハン ノ サツ
薪	タキギ，マキワリ ノ マキ
薫	クンプウ ノ クン，カオル
薬	ヤクヒン ノ ヤク，クスリ
薮	ヤブ，クサカンムリ ニ サンスウ ノ スウ
薯	バレイショ ノ ショ，イモ
薹	ダイ，トウガタツノトウ
薺	ナナクサノナズナ，セイ
藁	ムギワラ ノ ワラ
藉	セキ，ロウゼキモノノセキ，
藍	アイイロ ノ アイ，ラン
藏	レイゾウコノゾウノイタイジ
藐	バク，クサカンムリニワカサトビボウノボウ
藕	グウ，クサカンムリニスキヘンニグウゼンノグウノツクリ，
藜	アカザ，レイ
藝	ゲイジュツノゲイノキュウジ
藤	フジ ノ ハナ ノ フジ，トウ
藥	クスリノイタイジ
藩	ハイハンチケン ノ ハン
藪	ヤブ，ソウ
藷	クサカンムリ ニ ショクン ノ ショ
藹	ワキアイアイノアイ
藺	イグサノイ，リン
藻	ウミ ノ モクズ ノ モ，ソウ
藾	ライ，クサカンムリニイライスルノライノキュウジ
蘂	メシベノシベ，ズイノイタイジ，クサカンムリニココロミッツニジュモクノモク
蘆	アシ，クサカンムリニハゼノキノハゼノツクリ
蘇	ソセイスル ノ ソ，ヨミガエル
蘊	ウンチクヲカタムケルノウン，イトヘン
蘋	ヒン，クサカンムリニヒンパンナノヒンノキュウジ
蘓	ソセイノソノイタイジ，クサカンムリニノギヘンニサカナ
蘖	ゲツ，ヒコバエ
蘗	オウバクシュウノバクノイタイジ
蘚	セン，コケ，クサカンムリニシンセンナノセン
蘢	ロウ，クサカンムリニキョウリュウノリュウノキュウジ
蘭	ランガク ノ ラン
蘯	ホウトウムスコノトウノイタイジ
蘰	カズラ，クサカンムリニイトヘンニウナギノツクリ
蘿	ラ，クサカンムリニモウラスルノラ
虍	コ，ブシュノトラガシラ
虎	トラ，モウコ ノ コ
虐	ギャクタイ ノ ギャク，シイタゲル
虔	ケイケンナイノリノケン
處	ショブンスルノショノキュウジ
虚	キョエイシン ノ キョ
虜	ホリョ ノ リョ，トリコ
虞	グビジンソウ ノ グ
號	バンゴウノゴウノキュウジ
虧	キ，トラガシラニフルトリミギニオセンスルノオノツクリ
虫	ムシ，コンチュウ ノ チュウ
虱	シラミ，カゼノイッカクメヲトッタモノ
虹	ニジ，ナナイロ ノ ニジ
虻	アブハチトラズ ノ アブ
蚊	カトリセンコウ ノ カ
蚋	ゼイ，ムシヘンニコクナイノナイ
蚌	イツボウノアラソイノボウ
蚓	イン，ミミズ，ムシヘンニインリョクノイン
蚕	ヨウサン ノ サン，カイコ
蚣	コウ，ムシヘンニオオヤケ
蚤	ムシ ノ ノミ
蚩	オロカヲイミスルシ
蚪	トウ，ムシヘンニホクトシチセイノト
蚫	アワビ，ムシヘンニツツム
蚯	キュウ，ムシヘンニサキュウノキュウ
蚰	ユウ，ムシヘンニリユウノユウ
蚶	カン，ムシヘンニアマイ
蛄	スシネタノシャコノコ
蛆	ウジムシノウジ，ショ
蛇	ヘビ，ダイジャ ノ ジャ
蛉	トンボノニモジメ，レイ，ムシヘンニメイレイスルノレイ
蛋	タンパクシツ ノ タン
蛍	ホタル，ケイコウトウ ノ ケイ
蛎	ウミ ノ カキ，レイ
蛔	カイ、ムシヘンニカイスウケンノカイ
蛙	ドウブツ ノ カエル
蛛	クモ，ムシヘンニシュイロノシュ
蛞	ナメクジノイチモジメ，ムシヘンニシタヲカムノシタ
蛟	コウ、ミズチ、ムシヘンニマジワル
蛤	ハマグリ，ムシヘン ニ アウ
蛩	キョウ、キョウリュウノキョウノココロノカワリニムシ
蛬	キョウ、キョウツウスルノキョウノシタニムシ
蛭	チヲスウドウブツ ノ ヒル
蛮	ナンバンボウエキ ノ バン
蛯	エビ，ムシヘンニロウジンノロウ
蛸	ギョカイルイ ノ タコ
蛹	ムシノサナギ、ヨウ
蛻	モヌケノカラノモヌケ
蛾	ガ，ムシ ノ ガ
蜀	サンゴクシノショク
蜂	ハチミツ ノ ハチ，ホウ
蜃	シンキロウノシン
蜆	シジミ，ケン
蜈	ゴ，ムシヘンニゴフクヤノゴノキュウジケイ
蜉	フ，ムシヘンニツメノシタニコドモノコ
蜊	カイノアサリ、ムシヘンニケンリノリ
蜍	ジョ、ムシヘンニアマリ
蜑	タン，エンチョウスルノエンノシタニムシ
蜒	エン，ムシヘンニエンチョウスルノエン
蜘	クモ，ムシヘン ニ チシキ ノ チ
蜚	ゴキブリノイチモジメ，ヒジョウグチノヒノシタニムシ
蜜	ハチミツ ノ ミツ
蜥	セキ，ムシヘンニブンセキスルノセキ
蜩	ヒグラシ、ムシヘンニシュウヘンノシュウ
蜴	エキ、ムシヘンニボウエキフウノエキ
蜷	ニナ，ムシヘンニノリマキノマキノキュウジ
蜻	トンボノイチモジメ，セイ、ムシヘンニアオノキュウジ
蜿	エン、ムシヘンニアテナノアテ
蝉	セミシグレ ノ セミ
蝋	ロウソクタテ ノ ロウ
蝌	カ、ムシヘンニキョウカショノカ
蝎	ダカツノゴトクキラウノカツ、ムシヘンニカッショクノカツノツクリ
蝓	ナメクジノニモジメ，ムシヘンニニレノキノニレノツクリ
蝕	ニッショク ノ ショク，ムシバム
蝗	コウ、イナゴ、ムシヘンニコウタイシノコウ
蝙	コウモリノイチモジメ、ムシヘンニヘンペイソクノヘン
蝟	イ、ムシヘンニイブクロノイ
蝠	コウモリノニモジメ，ムシヘンニフクカイチョウノフクノヒダリガワ
蝣	ユウ、アソブノシンリョウノカワリニムシヘン
蝦	ムシヘン ノ エビ，カ
蝨	シラミ
蝪	トウ，ムシヘンニバショノバノツクリ
蝮	ヘビノマムシ、フク
蝴	コ、ムシヘンニクロコショウノコ
蝶	アゲハチョウ ノ チョウ
蝸	カタツムリノカギュウノカ
蝿	ムシ ノ ハエ
螂	カマキリヲイミスルトウロウノロウ，ムシヘンニモモタロウノロウ
融	キンユウ ノ ユウ
螟	メイ，ムシヘンニメイフクヲイノルノメイ
螢	ホタル，ケイコウトウノケイノキュウジ
螫	セキ，オンシャヲウアタエルノシャノシタニムシ
螯	ゴウ，ゴウマンナノゴウノツクリノシタニムシ
螳	カマキリヲイミスルトウロウノトウ，ムシヘンニコウカイドウノドウ
螺	ラセン ノ ラ
螻	ロウ，ムシノケラノイチモジメ
螽	シュウ，キセツノフユノシタニムシフタツ
蟀	コオロギノニモジメ，ムシヘンニソツギョウノソツ
蟄	ケイチツノチツ
蟆	ガマガエル，バクノイタイジ
蟇	ガマガエル，バク
蟋	コオロギノイチモジメ，ムシヘンニノゴメノシタニココロ
蟐	アカガエル，ムシヘンニヒジョウグチノジョウ
蟒	ウワバミヲイミスルボウ，クサカンムリニソウモウノシンノモウ
蟠	ワダカマル，ハン，ムシヘンニバンゴウノバン
蟯	ギョウチュウノギョウ
蟲	ムシ，コンチュウノチュウノキュウジ
蟶	マテガイノマテ，ムシヘンニヒジリ
蟷	カマキリヲイミスルトウロウノトウ，ムシヘンニベントウノトウノキュウジ
蟹	カニ
蟻	ムシ ノ アリ，ギ
蟾	セン，ムシヘンニタンニンノタンノキュウジノツクリ
蠅	ムシノハエ
蠍	サソリ
蠎	ウワバミヲイミスルボウ，クサカンムリニホンソウスルノホン
蠏	カニノイタイジ，ムシヘンニカイケツスルノカイ
蠑	エイ，ムシヘンニサカエルノキュウジ
蠕	ゼンドウウンンドウノゼン
蠖	カク，ムシヘンニカクトクスルノカクノツクリ
蠡	レイ，ケイガシラニイノコ，ソノシタニムシフタツ
蠢	ウゴメク，シュン
蠣	カキ，ムシヘンニゲキレイスルノレイノキュウジノヒダリガワ
蠧	ホンニツクムシノトギョノト
蠱	コワクスルノコ，ムシミッツノシタニサラ
蠶	ヨウサンノサン，カイコノキュウジ
蠹	ホンニツクムシノトギョノトノイタイジ
蠻	ナンバンボウエキノバンノキュウジ
血	ケツエキ ノ ケツ，チ
衂	ジク，チヘンニヤイバノイタイジ
衄	ジク，チヘンニジュウニシノウシ
衆	シュウギイン ノ シュウ
行	リョコウ ノ コウ，イク
衍	フエンスルノエン
衒	キヲテラウノテラウ，ゲン
術	ゲイジュツ ノ ジュツ
街	ガイロジュ ノ ガイ
衙	ヤクショヲオイミスルカンガノガ
衛	エイセイテキ ノ エイ
衝	ショウトツスル ノ ショウ
衞	エイセイテキノエイノキュウジ
衡	ヘイコウカンカク ノ コウ
衢	チマタヲイミスルガイクノク
衣	イフク ノ イ，コロモ
表	ウラオモテ ノ オモテ，ヒョウ
衫	サン，コロモヘンニサンヅクリ
衰	スイジャクスル ノ スイ，オトロエル
衲	ノウ、コロモヘンニコクナイノナイ
衵	ジツ、コロモヘンニニチヨウビノニチ
衷	ワヨウセッチュウ ノ チュウ
衽	ジン、コロモヘンニジンシンノランノジン
衾	ドウキンスルノキン
衿	エリ，コロモヘン ニ イマ
袁	エン，ルイジンエンノエンノツクリ
袂	タモト
袈	オボウサン ノ ケサ ノ ケ
袋	フクロ，ユウタイルイ ノ タイ
袍	ホウ、コロモヘンニツツム
袒	サタンスルノタン、ハダヌグ
袖	フリソデ ノ ソデ
袗	シン、コロモヘンニシンサツシツノシンノツクリ
袙	バク、コロモヘンニクロシロノシロ
袞	コンリョウノソデノコン
袢	ジュバンノバン
袤	ボウ，コロモノアイダニムジュンノム
被	ヒガイシャ ノ ヒ，コウムル
袮	ネ、コロモヘンニイチニンショウノショウノツクリ
袰	ホロ、ハハノシタニコロモ
袱	フク、チャブダイノニモジメ
袴	ハオリハカマ ノ ハカマ
袵	ジン、コロモヘンニセキニンノニン
袷	アワセ，コロモヘン ニ ゴウカク ノ ゴウ
袿	ケイ、コロモヘンニツチフタツ
裁	サイバン ノ サイ，サバク
裂	ブンレツスル ノ レツ，サケル
裃	レイフクノカミシモ
裄	ユキタケノユキ、コロモヘンニリョコウキノコウ
装	フクソウ ノ ソウ
裏	ウラオモテ ノ ウラ
裔	マツエイノエイ
裕	ヨユウ ノ ユウ
裘	キュウ、カワゴロモ
裙	クン、コロモヘンニショクンノクン
補	ホジョ ノ ホ，オギナウ
裝	フクソウノソウノキュウジ
裟	オボウサン ノ ケサ ノ サ
裡	キンリ ノ リ，コロモヘン ニ サト
裨	ヒ、コロモヘンニヒクツナノヒ
裲	リョウ、コロモヘンニリョウテノリョウノキュウジ
裳	イショウ ノ ショウ，モスソ
裴	ハイ、ヒジョウグチノヒノシタニコロモ
裸	ハダカ，ラタイ ノ ラ
裹	カ、コロモノアイダニコウカテキノカ
裼	セキ、コロモヘンニボウエキフウノエキ
製	セイゾウスル ノ セイ
裾	スソノ ノ スソ
褂	カイ、コロモヘンニカケブトンノカケノツクリ
褄	ツジツマガアウノツマ
複	フクザツ ノ フク
褊	ヘン、コロモヘンニヘンペイソクノヘン
褌	フンドシ、コロモヘンニグンタイノグン
褐	カッショク ノ カツ
褒	ホメル，ホウビ ノ ホウ
褓	ホウ、ムツキ、コロモヘンニホケンシツノホ
褝	タン、コロモヘンニタンジュンノタン
褞	オン、コロモヘンニオンセンノオンノキュウジノツクリ
褥	サンジョクノジョク、コロモヘンニブジョクノジョク
褪	イロアセルノアセル、コロモヘンニタイクツノタイ
褫	チ，テイシンショウノテイノキュウジノシンニョウノカワリニコロモヘン
褶	シュウキョクサンミャクノシュウ、ヒダ
褸	ランルヲマトウノル
褻	ワイセツナノセツ
襁	キョウ、コロモヘンニベンキョウノキョウ
襃	キヨホウヘンノホウノイタイジ
襄	ジョウ，ユズルノキュウジノツクリ
襌	タン、コロモヘンニタンジュンノタンノキュウジ
襍	ザツオンノザツノイタイジ
襖	ショウジフスマ ノ フスマ
襞	ヒダ，カベノツチノカワリニコロモ
襟	エリマキ ノ エリ
襠	トウ、コロモヘンニベントウノトウノキュウジ
襤	ランルヲマトウノラン
襦	ジュバンノジュ
襪	ベツ，コロモヘンニケイベツスルノベツ
襭	ケツ，コロモヘンニダイキチノキチニページ
襯	シン、コロモヘンニオヤコノオヤ
襲	シュウゲキ ノ シュウ，オソウ
襴	キンランドンスノラン
襷	タスキ
襾	エ，ブシュノオオイカンムリ
西	ニシヒガシ ノ ニシ，セイ
要	ヨウキュウスル ノ ヨウ
覃	タン，オオイカンムリノシタニハヤオキノハヤイ
覆	フクメン ノ フク，オオウ
覇	セイハスル ノ ハ
覈	ガク，オオイカンムリニゲキレイスルノゲキノツクリ
覊	キビセイサクノキノイタイジ
見	ミル，ケンブツ ノ ケン
規	キソクテキ ノ キ
覓	ベキ，ツメノシタニケンブツスルノケン
視	シリョクケンサ ノ シ
覗	ノゾキミル ノ ノゾク
覘	テン，ドクセンスルノセンノミギニケンブツスルノケン
覚	カンカク ノ カク，オボエル
覡	ケキ，ジンジャノミコノフノミギニケンブツスルノケン
覦	ユ，ニレノキノニレノツクリノミギニケンブツスルノケン
覧	ハクランカイ ノ ラン
覩	ト，カガクシャノシャノキュウジタイノミギニケンブツスルノケン
親	オヤ，リョウシン ノ シン
覬	キ，ガイセンモンノガイノミギニケンブツスルノケン
覯	コウ，ミゾノツクリノミギニケンブツスルノケン
覲	キン，キンムノキンノキュウジタイノチカラノカワリニケンブツスルノケン
観	カンキャク ノ カン
覺	カンカクノカク，オボエルノキュウジ
覽	ハクランカイノランノキュウジ
覿	コウカテキメンノテキ
觀	カンキャクノカン，ミルノキュウジ
角	カクド ノ カク，ツノ
觚	コ，ツノヘンニウリ
觜	クチバシ，シ，ヒガンシガンノシノシタニツノ
觝	テイ，ツノヘンニテイコウスルノテイノツクリ
解	カイケツスル ノ カイ
触	セッショクスル ノ ショク，フレル
觧	カイ，ツノヘンニヒツジ
觴	ショウ、ツノヘンニキリキズノキズノツクリ
觸	セッショクスルノショク，フレルノキュウジ
言	ゲンゴ ノ ゲン，イウ
訂	テイセイスル ノ テイ
訃	フホウヲキクノフ
計	トケイ ノ ケイ，ハカル
訊	ジンモン ノ ジン，トウ
訌	コウ、ゴンベンニズガコウサクノコウ
討	トウロンスル ノ トウ
訐	ケツ，ゴンベンニホス
訓	クンレン ノ クン
訖	キツ，ゴンベンニアマゴイノコウ
託	タクジショ ノ タク
記	キロク ノ キ，シルス
訛	オクニナマリノナマリ、カ
訝	ケゲンナカオノゲン、イブカル
訟	ソショウ ノ ショウ
訣	ケツベツ ノ ケツ，ワカレル
訥	ボクトツノトツ
訪	ホウモンスル ノ ホウ，オトズレル
設	セツビ ノ セツ
許	キョカスル ノ キョ，ユルス
訳	ツウヤク ノ ヤク，ワケ
訴	ウッタエル，ソショウ ノ ソ
訶	マカフシギノカ
診	シンサツスル ノ シン，ミル
註	チュウシャク ノ チュウ，ゴンベン ニ シュジンコウ ノ シュ
証	ショウメイショ ノ ショウ
詁	クンコガクノコ、ゴンベンニチュウコシャノコ
詆	テイ，ゴンベンニテイコウスルノテイノツクリ
詈	バリゾウゴンノリ
詐	サギシ ノ サ
詑	タ，ゴンベン ニ ウカンムリ ニ カタカナ ノ ヒ
詒	タイ，ゴンベンニダイドコロノダイ
詔	ショウチョク ノ ショウ，ミコトノリ
評	ヒョウカスル ノ ヒョウ
詛	ジュソノソ、ゴンベンニナオカツノカツ
詞	サクシサッキョク ノ シ
詠	エイタン ノ エイ，ヨム
詢	ジュン，ゴンベンニゲジュンノジュン
詣	モウデル，サンケイスル ノ ケイ
試	シアイ ノ シ，ココロミル
詩	シヲツクル ノ シ
詫	オワビスル ノ ワビ
詬	コウ，ゴンベンニコウゴウヘイカノゴウ
詭	キベンヲロウスルノキ
詮	センサクスル ノ セン
詰	ツメル，キツモン ノ キツ
話	ハナシ，デンワ ノ ワ
該	ガイトウスル ノ ガイ
詳	ショウサイ ノ ショウ，クワシイ
詼	カイ，ゴンベンニハイイロノハイノキュウジタイ
誂	アツラエル，チョウ
誄	ルイ，ゴンベンニライスキ
誅	テンチュウヲクワエルノチュウ
誇	ホコリ，コチョウスル ノ コ
誉	メイヨ ノ ヨ，ホマレ
誌	ザッシ ノ シ
認	カクニン ノ ニン，ミトメル
誑	タブラカス，キョウ
誓	チカウ，セイヤクショ ノ セイ
誕	タンジョウビ ノ タン
誘	サソウ，ユウワク ノ ユウ
誚	ショウ，ゴンベンニショウゾウガノショウ
語	コクゴ ノ ゴ，カタル
誠	セイジツナ ノ セイ，マコト
誡	カイ，ゴンベンニイマシメル
誣	ブコクザイノブ
誤	ゴカイスル ノ ゴ，アヤマリ
誥	コウ，ゴンベンニツゲル
誦	シヲアンショウスルノショウ
誨	カイ，ゴンベンニマイニチノマイ
説	セツメイ ノ セツ，トク
読	ヨム，ドクショ ノ ドク
誰	ダレカサン ノ ダレ
課	ホウカゴ ノ カ
誹	ヒボウスル ノ ヒ，ソシル
誼	ヨシミヲツウズル ノ ヨシミ，ギ
調	チョウサ ノ チョウ，シラベル
諂	ヘツラウ，テン
諄	ジュン，ゴンベンニキョウラクテキノキョウ
談	ジョウダンヲイウ ノ ダン
請	セイキュウショ ノ セイ，コウ
諌	イサメル，カンゲンスル ノ カン
諍	イサカイ，ソウ
諏	スワコ ノ ス
諒	リョウカイスル ノ リョウ，ゴンベン ニ キョウト ノ キョウ
論	ケツロン ノ ロン
諚	ジョウ，ゴンベンニサダメル
諛	ユ，ゴンベンニシュユノマノユ
諜	チョウホウキカン ノ チョウ
諞	ヘン，ゴンベンニヘンペイソクノヘン
諠	ケン，ゴンベンニセンデンスルノセン
諡	オクリナ，シゴウノシ
諢	コン，ゴンベンニグンタイノグン
諤	カンカンガクガクノガク
諦	アキラメル，テイカンスル ノ テイ
諧	カイギャクノカイ
諫	イサメル，カン
諭	キョウユ ノ ユ，サトス
諮	シモンスル ノ シ，ハカル
諱	イミナ，ゴンベンニイダイナノイノツクリ
諳	ソランズル，アン
諷	フウシノフウ，ゴンベンニカゼ
諸	ショクン ノ ショ
諺	コトワザ，ゲン
諾	ショウダクスル ノ ダク
謀	インボウ ノ ボウ，ハカル
謁	ハイエツスル ノ エツ
謂	イワレ，ゴンベン ニ イブクロ ノ イ
謄	コセキトウホン ノ トウ
謇	ケン，サムイノシタニテンノカワリニゴンベン
謌	ウタ，カ，ゴンベンニカノウセイノカヲカサネル
謎	ナゾヲトク ノ ナゾ
謐	セイヒツナノヒツ
謔	カイギャクノギャク
謖	ナイテバショクヲキルノショク
謗	ヒボウスルノボウ，ソシル
謙	ケンソンスル ノ ケン
謚	オクリナ，シゴウノシノイタイジ
講	コウシュウカイ ノ コウ
謝	カンシャスル ノ シャ
謠	ミンヨウノヨウノキュウジ
謡	ミンヨウ ノ ヨウ
謦	ケイガイニセッスルノケイ
謨	ボ、ゴンベンニバクダイナノバク
謫	タク、ゴンベンニテキハツスルノテキノツクリ
謬	ゴビュウ ノ ビュウ
謳	セイシュンヲオウカスルノオウ
謹	キンガシンネン ノ キン
謾	マン、ゴンベンニウナギノツクリ
譁	カ、ゴンベンニチュウカナベノカ
證	ショウ、ショウメイショノショウノキュウジ
譌	オクニナマリノナマリノイタイジ
譎	ケツ、ゴンベンニタチバナノツクリ
譏	キ、ゴンベンニキカガクノキ
譖	シン，ゴンベンニセンエツナガラノセンノツクリ
識	チシキ ノ シキ
譚	タン，ゴンベンニニシノシタニハヤオキノハヤイ
譛	シン，ゴンベンニフリカエノカエ
譜	フメン ノ フ
譟	ソウ、ゴンベンニソウジュウスルノソウノツクリ
警	ケイサツ ノ ケイ
譫	センモウジョウタイノセン
譬	タトエバナシノタトエ、ヒ
譯	ツウヤクスルノヤク、ワケノキュウジ
議	カイギシツ ノ ギ
譱	ゼンアクノゼン，ヨイノイタイジ
譲	ジョウホスル ノ ジョウ，ユズル
譴	ケンセキショブンノケン、セメル
護	ホゴシャ ノ ゴ
譽	メイヨノヨ、ホマレノキュウジ
讀	ドクショノドク、ヨムノキュウジ
讃	ゴンベン ノ ツイタ サンビカ ノ サン
變	ヘンカスルノヘン，カエルノキュウジ
讌	エン、ゴンベンニツバメ
讎	フクシュウスルノシュウ、アダノイタイジ
讐	フクシュウスル ノ シュウ，アダ
讒	ザンゲンンスルノザン、ソシル
讓	ジョウホスルノジョウ、ユズルノキュウジ
讖	ヨゲンヲイミスルゴンベンノシン
讙	カン，ゴンベンニカンガイヨウスイノカンノツクリ
讚	ゴンベンノツイタサンビカノサンノイタイジ
谷	タニガワ ノ タニ，コク
谺	カ、コダマ、タニヘンニキバ
谿	ケイ，ケイリュウヅリノケイノキュウジノツクリノミギニタニ
豁	カツゼントサトルノカツ
豆	トウフ ノ トウ，マメ
豈	アニハカランヤノアニ
豊	ホウサク ノ ホウ，ユタカ
豌	エンドウマメノエン
豎	ジュ、ケンジツナノケンノツチノカワリニマメ
豐	ユタカナノキュウジ
豕	シ，ブシュノイノコ
豚	ブタ，トンジル ノ トン
象	インショウテキ ノ ショウ，ゾウ
豢	コブシノテノカワリニイノコ
豪	ゴウカイナ ノ ゴウ
豫	ヨテイノヨノキュウジ
豬	チョ、イノコノミギニカガクシャノシャノキュウジタイ
豸	チ，ブシュノムジナ
豹	ドウブツ ノ ヒョウ
豺	サイロウノムレノサイ、ヤマイヌ
豼	ヒ，ムジナヘンニヒカクスルノヒ
貂	ドウブツノテン
貅	キュウ、ムジナヘンニヤスム
貉	ムジナヘンノドウブツノムジナ
貊	ハク、ムジナヘンニカンスウジノヒャク
貌	ビボウ ノ ボウ，カタチ
貍	リ、ムジナヘンニサトガエリノサト
貎	ゲイ、ムジナヘンニジドウセイトノジノキュウジ
貔	ユウモウナグンタイヲイミスルヒキュウノヒ
貘	ムジナヘンノドウブツノバク
貝	カイガラ ノ カイ
貞	テイシュク ノ テイ
負	カチマケ ノ マケ，フ
財	ザイサン ノ ザイ
貢	シャカイコウケンスル ノ コウ，ミツグ
貧	ヒンジャク ノ ヒン，マズシイ
貨	カモツ ノ カ
販	ハンバイスル ノ ハン
貪	ドンヨクノドン、ムサボル
貫	イッカンスル ノ カン，ツラヌク
責	セキニン ノ セキ
貭	シツモンノシツノイタイジ
貮	カンスウジノニノイタイジ，ブキノブノトメルノカワリニカイガラノカイ
貯	チョキン ノ チョ，タクワエル
貰	モラウ
貲	シ、ヒガンシガンノシノシタニカイガラノカイ
貳	カンスウジノニ，シキガマエニ，ニノシタニカイガラノカイ
貴	キチョウヒン ノ キ
貶	キヨホウヘンノヘン，オトシメル
買	カウ，バイシュウ ノ バイ
貸	ホンヲカス ノ カ
費	ショウヒ ノ ヒ
貼	ハル，カイヘン ニ ウラナウ
貽	イズシノイ、カイヘンニダイドコロノダイ
貿	ボウエキコウ ノ ボウ
賀	ネンガジョウ ノ ガ
賁	ヒ，フンカスルノフンノツクリ
賂	ワイロ ノ ロ
賃	チンギン ノ チン
賄	ワイロ ノ ワイ，マカナウ
資	シゲン ノ シ
賈	コ、オオイガシラニカイガラノカイ
賊	サンゾク ノ ゾク
賍	ゾウブツザイノゾウノタイジ
賎	イヤシイ，セン
賑	ニギワウ，インシン ノ シン
賓	ライヒン ノ ヒン
賚	ライ，ライネンノライノキュウジノシタニカイガラノカイ
賛	サンセイスル ノ サン
賜	オンシ ノ シ，タマワル
賞	ノーベルショウ ノ ショウ
賠	バイショウキン ノ バイ
賢	ケンジャ ノ ケン，カシコイ
賣	ショウバイノバイ、ウルノキュウジ
賤	ゲセンナノセン，イヤシイ
賦	ゲップバライ ノ フ
質	シツモン ノ シツ
賭	トバク ノ ト，カケル
賺	ナダメスカスノスカス
賻	フ、カイヘンニハクブツカンノハクノツクリ
購	コウニュウスル ノ コウ
賽	サイセンバコノサイ
贄	イケニエノニエ
贅	ゼイタクノゼイ
贇	ゲンピンヤキノイン
贈	ゾウトウヒン ノ ゾウ，オクル
贊	サンセイハンタイノサンノキュウジ
贋	ガンサク ノ ガン，ニセ
贍	セン，カイヘンニクシンサンタンノタンノツクリ
贏	カチマケヲイミスルエイシュノエイ
贐	ハナムケ、ジン
贓	ゾウブツザイノゾウ
贔	ヒイキノヒ、カイミッツ
贖	ショクザイノショク，アガナウ
赤	アカンボウ ノ アカ，セキ
赦	オンシャ ノ シャ，ユルス
赧	カオヲアカラメルイミノタンガンノタン
赫	アカヲ フタツ ナラベタ カク
赭	シャ，アカイロノアカノミギニカガクシャノシャノキュウジタイ
走	ハシル，キョウソウ ノ ソウ
赱	ハシル，キョウソウノソウノイタイジ
赳	キュウ、ソウニョウニサケブノツクリ
赴	フニンスル ノ フ，オモムク
起	キリツスル ノ キ，オキル
趁	チン，ソウニョウニメズラシイノツクリ
超	チョウノウリョク ノ チョウ，コエル
越	ユウエツカン ノ エツ，コス
趙	チュウゴクノコクメイノチョウ
趣	シュミ ノ シュ，オモムキ
趨	スウセイ ノ スウ
足	アシ，エンソク ノ ソク
趺	フ，アシヘンニオット
趾	ジョウシコウエンノシ
跂	キ，アシヘンニササエル
跋	チョウリョウバッコノバツ
跌	ジンセイノサテツノテツ
跏	カ、アシヘンニカソクドノカ
跖	セキ、アシヘンニイシ
跚	スイホマンサンノサン、アシヘンニイッサツニサツノサツ
跛	ハ，アシヘンニケガワノカワ
距	キョリ ノ キョ
跟	コン，アシヘンニダイコンノコンノツクリ
跡	ツイセキスル ノ セキ，アト
跣	セン，アシヘンニイキサキノサキ
跨	コセンキョウ ノ コ，マタグ
跪	ヒザマズク，キ
跫	キョウ、キョウリュウノキョウノココロノカワリニテアシノアシ
路	ドウロ ノ ロ
跳	チョウヤクスル ノ チョウ，トブ
践	ジッセンスル ノ セン
跼	キョク，アシヘンニヤッキョクノキョク
跿	ト，アシヘンニダッソウスルノソウ
踈	カソチノソノイタイジ，アシヘンニヤクソクノソク
踉	ヨロメク，ソウロウノロウ
踊	オドル，ブヨウ ノ ヨウ
踏	フム，ザットウ ノ トウ
踐	ジッセンスルノセンノキュウジ
踝	クルブシ，カ
踞	ソンキョスルノキョ，アシヘンニジュウキョノキョ
踟	チ，アシヘンニケンチジノチ
踪	シッソウジケンノソウ
踰	ユ，アシヘンニニレノキノニレノツクリ
踴	オドル，ブヨウノヨウノイタイジ，アシヘンニイサマシイ
踵	カカト，ショウ
蹂	ジュウリンスルノジュウ
蹄	テイテツ ノ テイ，ヒヅメ
蹇	ケン，サムイノシタニテンノカワリニアシ
蹈	トウ，アシヘンニイネノキュウジノツクリ
蹉	ジンセイノサテツノサ
蹊	ケイ，アシヘンニケイリュウヅリノケイノキュウジノツクリ
蹌	ヨロメク，ソウロウノソウ
蹐	セキ，アシヘンニセキズイノセキ
蹕	ヒツ，アシヘンニヒッキョウノヒツ
蹙	ヒンシュクヲカウノシュク
蹟	キセキ ノ セキ，アシヘン ニ セキニン ノ セキ
蹠	セキ，アシヘンニショミンノショ
蹣	スイホマンサンノマン，アシヘンニマンゾクノマンノキュウジノツクリ
蹤	ショウ，アシヘンニジュウジスルノジュウノキュウジ
蹲	ソンキョスルノソン，アシヘンニソンケイスルノソン
蹴	ケル，シュウキュウ ノ シュウ
蹶	ケツ，アシヘンニユウボクミンゾクノトッケツノケツ
蹼	ホク，アシヘンニダボクノボクノツクリ
躁	ソウウツビョウノソウ
躄	ヘキ，カベノツチノカワリニテアシノアシ
躅	チョク，アシヘンニサンゴクシノショク
躇	チュウチョスルノチョ
躊	チュウチョスルノチュウ
躋	セイ，アシヘンニヘソノツクリ
躍	カツヤクスル ノ ヤク
躑	テキ，アシヘンニトウテキキョウギノテキノツクリ
躓	ツマズク，チ
躔	テン，アシヘンニマトウノツクリ
躙	ジュウリンスルノリン
躡	ジョウ、アシヘンニミミミッツ
躪	ジュウリンスルノリンノイタイジ
身	シンチョウタイジュウ ノ シン，ミ
躬	キュウ、ミヘンニユミ
躯	タイク ノ ク，ミ
躰	タイ，ミヘンニホンモノノホン
躱	タ、ミヘンニジダノジ
躾	シツケ、ミヘンニウツクシイ
軅	ヤガテ、ミヘンニトリノカリ
軆	タイ、ミヘンニユタカ
軈	ヤガテ、ミヘンニオウエンスルノオウノキュウジ
車	クルマ，デンシャ ノ シャ
軋	アツレキノアツ
軌	キドウニノル ノ キ
軍	グンタイ ノ グン
軒	イッケンヤ ノ ケン，ノキ
軛	クビキ、クルマヘンニヤクドシノヤク
軟	ジュウナン ノ ナン，ヤワラカ
転	ウンテン ノ テン，コロガス
軣	ゴウ、トドロクノイタイジ
軫	シン、クルマヘンニシンサツスルノシンノツクリ
軸	カケジク ノ ジク
軻	カ、クルマヘンニカノウセイノカ
軼	イツ、クルマヘンニウシナウ
軽	カルイオモイ ノ カルイ，ケイ
軾	ショク、クルマヘンニニュウガクシキノシキ
較	ヒカクテキ ノ カク
輅	ロ、クルマヘンニカクジノカク
載	レンサイ ノ サイ，ノセル
輊	チ、クルマヘンニゲシトウジノシ
輌	リョウ、クルマヘンニリョウテノリョウ
輒	チョウ，クルマヘンニミミニオツ
輓	バン，クルマヘンニメンキョノメン
輔	クルマヘン ノ ホサ ノ ホ
輕	カルイオモイノカルイノキュウジ
輙	チョウ，クルマヘンニウケトルノトル
輛	リョウ、クルマヘンニリョウテノリョウノキュウジ
輜	シチョウヘイノシ
輝	カガヤク，キ
輟	テツ、クルマヘンニツヅルノツクリ
輦	ホウレンノレン、オットフタツノシタニクルマ
輩	センパイ コウハイ ノ ハイ
輪	シャリン ノ リン，ワ
輯	ヘンシュウ ノ シュウ，クルマヘン ニ クチニ ミミ
輳	ソウ、クルマヘンニカナデル
輸	ユニュウ ノ ユ
輹	フク、クルマヘンニオウフクスルノフクノツクリ
輻	フク、クルマヘンニシュクフクノフクノツクリ
輾	テン、クルマヘンニハッテンノテン
輿	タマノコシ ノ コシ
轂	コシキ、コクモツノコクノノギノカワリニクルマ
轄	カンカツスル ノ カツ
轅	エン、ナガエ、クルマヘンニルイジンエンノエンノツクリ
轆	ロクロノロク
轉	ウンテンスルノテンノキュウジ
轌	ソリ、クルマヘンニユキ
轍	ワダチ
轎	キョウ、クルマヘンニホドウキョウノキョウノツクリ
轗	カン、クルマヘンニカンソウブンノカン
轜	ジ、クルマヘンニヒツジュヒンノジュ
轟	ゴウオン ノ ゴウ，トドロク
轡	クツワ
轢	アツレキノレキ
轣	レキ、クルマヘンニレキシカノレキ
轤	ロクロノロ
辛	コウシンリョウ ノ シン，カライ
辜	ムコノコ，チュウコシャノコノシタニカライ
辞	コクゴジテン ノ ジ
辟	ヘキエキスルノヘキ
辣	ラツワンノラツ
辧	ベンベツスルノベンノキュウジ，カライ，シンフタツノアイダニカタナ
辨	ベンベツスルノベンノキュウジ，カライ，シンフタツノアイダニリットウ
辭	コクゴジテンノジノキュウジ
辮	ベンパツノベン，カライ，シンフタツノアイダニイト
辯	ベンゴシノベンノキュウジ，カライフタツノアイダニゲンゴノゲン
辰	タツ，ジュウニシ ノ タツ
辱	ブジョクスル ノ ジョク，ハズカシメル
農	ノウギョウ ノ ノウ
辷	シンニョウニカンスウジノイチ，スベル
辺	シュウヘン ノ ヘン，アタリ
辻	ヨツツジ ノ ツジ
込	モウシコム ノ コム
辿	タドル
迂	ウカイスル ノ ウ
迄	コレマデ ノ マデ
迅	ジンソクナ ノ ジン
迎	カンゲイスル ノ ゲイ，ムカエル
近	キンジョ ノ キン，チカイ
返	ヘンジ ノ ヘン，カエス
迚	トテモ、シンニョウニチュウガクノチュウ
迢	チョウ、シンニョウニチョウノウリョクノチョウノツクリ
迥	ケイ，シンニョウニケイガンノシノケイノツクリ
迦	オシャカサマ ノ カ
迩	シンニョウ ニ ナンジ ノ イタイジ ノ ニ
迪	テキ，シンニョウニリユウノユウ
迫	ハクリョク ノ ハク，セマル
迭	コウテツスル ノ テツ
迯	ニゲル，トウボウスルノトウノイタイジ
述	ジュツゴ ノ ジュツ，ノベル
迴	カイ、シンニョウニカイスウケンノカイ
迷	メイワク ノ メイ，マヨウ
迸	ホトバシル，ホウ
迹	セキ，シンニョウニソクセキヲノコスノセキノツクリ
迺	ナイ，シンニョウニニシヒガシノニシ
追	ツイセキスル ノ ツイ，オウ
退	タイクツ ノ タイ
送	ホウソウキョク ノ ソウ，オクル
逃	ニゲル，トウボウスル ノ トウ
逅	メグリアイノカイコウノコウ
逆	ギャクテン ノ ギャク，サカサ
逋	ホ、シンニョウニシジンノトホノホ
逍	サンポヲイミスルショウヨウノショウ
逎	シュウ，シンニョウニジュウニシノトリ
透	トウメイナ ノ トウ，スケル
逐	チクジ ノ チク
逑	キュウ、シンニョウニモトメル
逓	テイシンショウ ノ テイ
途	トチュウ ノ ト
逕	ケイ、シンニョウニケイドウミャクノケイノヒダリガワ
逖	テキ、シンニョウニイテキノテキ
逗	トウリュウスル ノ トウ，シンニョウ ニ マメ
這	ハウ
通	コウツウ ノ ツウ，トオル
逝	セイキョスル ノ セイ，ユク
逞	タクマシイ，テイ
速	ソクド ノ ソク，ハヤイ
造	カイゾウ ノ ゾウ，ツクル
逡	シュンジュンスルノシュン
逢	ダンジョ ノ アイビキ ノ アイ
連	レンラク ノ レン
逧	サコ，シンニョウニタニ
逮	タイホジョウ ノ タイ
週	イッシュウカン ノ シュウ
進	シンポ ノ シン，ススム
逵	キ、シンニョウニリクジョウノリクノツクリ
逶	イ，シンニョウニガッキュウイインノイ
逸	イツダツスル
逹	ハイタツノタツノイタイジ
逼	ヒッパクスル ノ ヒツ
逾	ユ，シンニョウニニレノキノニレノツクリ
遁	トンソウスル ノ トン
遂	スイコウスル ノ スイ，トゲル
遅	オソイ，チコク ノ チ
遇	ユウグウスル ノ グウ
遉	テイ，シンニョウニテイシュクナノテイ
遊	ユウエンチ ノ ユウ，アソブ
運	ウンドウ ノ ウン，ハコブ
遍	フヘンテキナ ノ ヘン
過	カコ ノ カ，スギル
遏	アツ，シンニョウニカッショクノカツノツクリ
遐	カ，シンニョウニヒマツブシノヒマノツクリ
遑	コウ、シンニョウニコウタイシノコウ
遒	シュウ，シンニョウニシュウチョウサンノシュウ
道	ミチ，ドウロ ノ ドウ
達	ハイタツ ノ タツ
違	イハン ノ イ，チガウ
遖	アッパレ，シンニョウニミナミ
遘	コウ，シンニョウニミゾノツクリ
遙	ヨウハイスルノヨウ，ハルカノキュウジ
遜	ケンソンスル ノ ソン
遞	テイシンショウノテイノキュウジ
遠	エンソク ノ エン，トオイ
遡	サカノボル，ソジョウスル ノ ソ
遣	ハケンスル ノ ケン，ツカワス
遥	ヨウハイスル ノ ヨウ，ハルカ
遨	ゴウ，シンニョウニゴウマンナノゴウノツクリ
適	テキトウ ノ テキ
遭	ソウナンスル ノ ソウ
遮	シャダンスル ノ シャ，サエギル
遯	トン，シンニョウニトンジルノトン
遲	チコクスルノチ，オソイノキュウジ
遵	ジュンシュスル ノ ジュン，シンニョウ ニ ソンケイ ノ ソン
遶	ジョウ，シンニョウニギョウシュンノギョウノキュウジ
遷	サセンスル ノ セン
選	センキョ ノ セン，エラブ
遺	イデン ノ イ
遼	ゼントリョウエン ノ リョウ，ハルカ
遽	キュウキョキタクスルノキョ
避	ヒショチ ノ ヒ，サケル
邀	ヨウ，シンニョウニゲキレイスルノゲキノツクリ
邁	マイシンスルノマイ
邂	メグリアウイミノカイコウノカイ
邃	スイ，シンニュウニアナカンムリニグンタイノタイノツクリ
還	カンレキ ノ カン，カエル
邇	ジ，シンニョウニソツジナガラノジ
邉	シュウヘンノヘン，アタリノキュウジノイタイジ
邊	シュウヘンノヘン，アタリノキュウジ
邏	ケイラスルノラ
邑	トユウ ノ ユウ，ムラ
那	ワカダンナ ノ ナ
邦	イホウジン ノ ホウ
邨	ムラ，シチョウソンノソンノイタイジ
邪	ジャマ ノ ジャ，ヨコシマ
邯	カンタンノユメノカン
邱	キュウ，サキュウノキュウノミギニオオザト
邵	ショウ，マネクノツクリノミギニオオザト
邸	テイタク ノ テイ，ヤシキ
郁	フクイク ノ イク
郊	トウキョウキンコウ ノ コウ
郎	モモタロウ ノ ロウ
郛	フ，ツメノシタニコドモノコノミギニオオザト
郡	チメイ ノ グン，コオリ
郢	エイ，ゾウテイスルノテイノミギニオオザト
郤	ケキ，タニノミギニオオザト
部	ブチョウ ノ ブ
郭	リンカク ノ カク，クルワ
郵	ユウビン ノ ユウ
郷	ウマレコキョウ ノ キョウ
都	トカイ ノ ト，ミヤコ
鄂	ガク，ワニノツクリノミギニオオザト
鄒	スウ，スウセイノスウノツクリノミギニオオザト
鄙	ヘンピナノヒ，ヒナ
鄭	ジンメイ ノ テイセイコウ ノ テイ
鄰	トナリ，リンジンノリンノタイジ
鄲	カンタンノユメノタン
酉	トリ，ジュウニシ ノ トリ
酊	メイテイスルノテイ
酋	シュウチョウ ノ シュウ
酌	バンシャク ノ シャク
配	ハイタツ ノ ハイ，クバル
酎	イモジョウチュウ ノ チュウ
酒	サケ，ニホンシュ ノ シュ
酔	ヨウ，デイスイ ノ スイ
酖	タン，ジュウニシノトリノミギニシズムノツクリ
酘	トウ，ジュウニシノトリノミギニルマタ
酢	スノモノ ノ ス
酣	カン，ジュウニシノトリノミギニアマイ
酥	ソ，ジュウニシノトリノミギニノギヘンノノギ
酩	メイテイスルノメイ
酪	ラクノウ ノ ラク
酬	ホウシュウ ノ シュウ
酲	テイ，ジュウニシノトリノミギニゾウテイスルノテイ
酳	イン，ジュウニシノトリノミギニイトガシラニツキ
酵	コウボキン ノ コウ
酷	ザンコク ノ コク，ヒドイ
酸	サンソ ノ サン
醂	ミリンノリン，ジュウニシノトリノミギニハヤシ
醇	ホウジュンナカオリ ノ ジュン
醉	デイスイスルノスイノキュウジ
醋	サク，ジュウニシノトリノミギニムカシ
醍	ダイゴミ ノ ダイ
醐	ダイゴミ ノ ゴ
醒	カクセイザイ ノ セイ，サメル
醗	サケヲハッコウサセル ノ ハツ，カモス
醜	シュウタイ ノ シュウ，ミニクイ
醢	カイ，ジュウニシノトリノミギニミギノシタニサラ
醤	ショウユ ノ ショウ，ヒシオ
醪	モロミ，ロウ
醫	オイシャサンノイノキュウジ
醯	ケイ，ジュウニシノトリノミギニナガレルノツクリノシタニサラ
醴	アマザケ，レイ
醵	キョキンノキョ，ジュウニシノトリノミギニゲキダンノゲキノヒダリガワ
醸	ジョウゾウスル ノ ジョウ，カモス
醺	ビクンヲオビルノクン
釀	ジョウゾウスルノジョウ，カモスノキュウジ
釁	スキマヲイミスルキンゲキノキン
釆	ハン，バンゴウ ノ バン カラ タ ヲ トッタ ジ
采	ハクシュカッサイ ノ サイ
釈	シャクホウスル ノ シャク
釉	ユウヤクノユウ，ウワグスリ
釋	シャクホウスルノシャクノキュウジ
里	サトガエリ ノ サト，リ
重	タイジュウ ノ ジュウ，オモイ
野	ヤサイ ノ ヤ，ノハラ ノ ノ
量	コウスイリョウ ノ リョウ，ハカル
釐	リ，ミライノミニノブンノシタニタンイノリン
金	キンヨウビ ノ キン，カネ
釖	トウ、カネヘンニカタナ
釘	クギ
釛	コク，カネヘンニチカラ
釜	カマメシ ノ カマ
針	ホウシン ノ シン，ハリ
釟	ハツ、カネヘンニカンスウジノハチ
釡	カマメシノカマノイタイジ
釣	サカナツリ ノ ツリ
釦	イフク ノ ボタン
釧	クシロ，コンセンゲンヤ ノ セン
釵	サイ、カネヘンニヤシャノシャ
釶	シ、カネヘンニクウヤネンブツノヤ
釼	ケン、カネヘンニヤイバ
釿	ギン、カネヘンニパンイッキンノキン
鈍	ドンカンナ ノ ドン，ニブイ
鈎	カギ，カネヘン ニ ツツミガマエ ニ ム
鈑	ハン、カネヘンニハンタイスルノハン
鈔	ショウ、カネヘンニオオイスクナイノスクナイ
鈕	チュウ、カネヘンニジュウニシノウシ
鈞	キン、カネヘンニヘイキンノキンノツクリ
鈩	ロ、カネヘンニトジマリノト
鈬	ドウタクノタクノイタイジ
鈴	スズムシ ノ スズ
鈷	カネヘン ニ フルイ ノ コ
鈿	ラデンノデン
鉄	テツドウ ノ テツ
鉅	キョ、カネヘンニキョダイナノキョ
鉈	ナタ
鉉	ゲン、カネヘンニゲンマイノゲン
鉋	ダイクドウグノカンナ
鉐	セキ、カネヘンニイシ
鉗	カンシブンベンノカン
鉚	リュウ、カネヘンニジュウニシノウ
鉛	エンピツ ノ エン，ナマリ
鉞	フエツノエツ、マサカリ
鉢	ハチウエ ノ ハチ
鉤	コウ、カギ、カネヘンニハイクノク
鉦	ショウコ ノ ショウ，カネヘン ニ タダシイ
鉱	テッコウセキ ノ コウ
鉾	カマボコ ノ ホコ
銀	ギンイロ ノ ギン
銃	ケンジュウウ ノ ジュウ
銅	ドウメダル ノ ドウ
銑	センテツ ノ セン，カネヘン ニ サキ
銓	セン、カネヘンニゼンコクノゼン
銕	テツノイタイジ、カネヘンニソンノウジョウイノイ
銖	シュ、カネヘンニシュイロノシュ
銘	メイガラ ノ メイ
銚	オチョウシ ノ チョウ
銛	モリデツクノモリ
銜	カン、ギョウガマエニキンヨウビノキン
銭	ツリセン ノ セン
銷	ショウ、カネヘンニショウゾウガノショウ
銹	シュウ、カネヘンニヒイデル
鋏	ドウグノハサミ
鋒	キュウセンポウ ノ ホウ，ホコサキ
鋤	ノウグ ノ スキ，カネヘン ニ タスケル
鋩	ボウ、カネヘンニクサカンムリニボウメイスルノボウ
鋪	カネヘン ノ ホ
鋭	エイリナ ノ エイ，スルドイ
鋲	ガビョウ ノ ビョウ
鋳	チュウゾウスル ノ チュウ，イル
鋸	ノコギリ，キョ
鋺	カナマリ、カネヘンニウデノツクリ
鋼	コウテツ ノ コウ，ハガネ
錆	サビドメ ノ サビ
錏	ア、カネヘンニアジアノアノキュウジ
錐	シカクスイ ノ スイ
錘	ボウスイケイ ノ スイ，オモリ
錙	シ、カネヘンニシチョウヘイノシノツクリ
錚	ソウ、カネヘンニアラソウノキュウジ
錠	テジョウ ノ ジョウ
錢	ツリセンノセンノキュウジ
錣	テツ、カネヘンニツヅルノツクリ
錦	ニシキ，キン
錨	イカリ，カネヘン ニ ナエ
錫	キンゾク ノ スズ，シャク
錬	レンキンジュツ ノ レン
錮	キンコケイノコ、カネヘンニカタメル
錯	サクランスル ノ サク
録	ロクオン ノ ロク
錵	ニエ、カネヘンニハナビノハナ
錺	カザリ、カネヘンニホウコウザイノホウ
錻	ブリキノブ、カネヘンニブキノブ
鍄	リョウ、カネヘンニトウキョウノキョウ
鍋	ナベモノ ノ ナベ
鍍	トキン ノ ト，カネヘン ニ オンドケイ ノ ド
鍔	カタナ ノ ツバ，ガク
鍖	チン、カネヘンニハナハダシイ
鍛	キタエル，タンレン ノ タン
鍜	カ，カネヘンニヒマツブシノヒマノツクリ
鍠	コウ、カネヘンニコウタイシノコウ
鍬	ノウグ ノ クワ，カネヘン ニ アキ
鍮	キンゾクノシンチュウノチュウ
鍵	カギ，ケンバン ノ ケン
鍼	シン，ハリキュウノハリ
鍾	ショウニュウドウ ノ ショウ
鎌	カマクラ ノ カマ
鎔	ヨウ、カネヘンニヨウセキノヨウ
鎖	サコク ノ サ，クサリ
鎗	ヤリ，カネヘン ニ クラ，ソウ
鎚	カネヘン ノ ツチ
鎧	ヨロイ，ガイシュウイッショク ノ ガイ
鎬	シノギヲケズルノシノギ
鎭	チンアツスルノチン，シズメルノキュウジ
鎮	チンアツスル ノ チン，シズメル
鎰	イツ、カネヘンニリエキノエキ
鎹	コハカスガイノカスガイ
鏃	ユミヤノヤジリ
鏈	レン、カネヘンニレンラクノレン
鏐	リョウ、カネヘンニニカワノツクリ
鏑	カブラヤ ノ カブラ
鏖	オウ、ドウブツノシカノシタニキンヨウビノキン
鏗	コウ、カネヘンニケンジツナノケン
鏘	ショウ、カネヘンニショウグンノショウノキュウジ
鏝	ハンダゴテノコテ
鏡	カガミ，ソウガンキョウ ノ キョウ
鏤	ルキンノル，チリバメル
鏥	シュウ，カネヘンニヤド
鏨	コウグノタガネ
鐃	ドウ、カネヘンニギョウシュンノギョウノキュウジ
鐇	ハン、カネヘンニバンゴウノバン
鐐	リョウ、カネヘンニドウリョウノリョウノツクリ
鐓	タイ、カネヘンニチュウゴクノトンコウノトン
鐔	タン，カネヘンニニシノシタニハヤオキノハヤイ
鐘	ケイショウヲナラス ノ ショウ，カネ
鐙	アブミ
鐚	ビタイチモンノビタ
鐡	テツドウノテツノキュウジノテイノカワリニマメノシタガワ
鐫	セン、カネヘンニフルトリノシタニオウトツノオウノシタ１カクヲトッタモノ
鐵	テツドウノテツノキュウジ
鐶	カン、カネヘンニジュンカンスルノカンノツクリ
鐸	ドウタク ノ タク
鐺	トウ、カネヘンニベントウノトウノキュウジ
鑁	バンナジノバン
鑄	チュウゾウスルノチュウ、イルノキュウジ
鑑	ズカン ノ カン
鑒	ズカンノカンノイタイジ
鑓	ヤリ，カネヘン ニ ハケンスル ノ ケン
鑚	ケンサンヲツムノサンノイタイジ
鑛	テッコウセキノコウノキュウジ
鑞	ロウヅケザイクノロウ
鑠	ゲンキカクシャクノシャク
鑢	コウグノヤスリ
鑪	ロ、カネヘンニハゼノキノハゼノツクリ
鑰	ヤク，カネヘンニブシュノヤク
鑵	カン、カネヘンニカンヅメノカンノキュウジノツクリ
鑷	ジョウ、カネヘンニミミミッツ
鑼	ドラヤキノラ
鑽	ケンサンヲツムノサン
鑾	ラン，コイビトノコイノキュウジノココロノカワリニキンヨウビノキン
鑿	コウグノノミ
钁	カク，カネヘンニゲンキカクシャクノカク
長	ナガイ，チョウタン ノ チョウ
門	センモン ノ モン
閂	カンヌキ
閃	ヒラメキ，センコウ ノ セン
閇	ヘイテンノヘイ，トジルノイタイジ
閉	ヘイテン ノ ヘイ，トジル
閊	ムネガツカエルノツカエル，モンガマエニヤマ
開	カイハツ ノ カイ，ヒラク
閏	ウルウドシ ノ ウルウ
閑	カンコドリ ノ カン，ヒマ
間	ジカン ノ カン，アイダ
閔	ビン，モンガマエニブンショウヲカクノブン
閖	ロウ，モンガマエニミズ
閘	コウ，モンガマエニコウオツノコウ
閙	ドウ，モンガマエニイチバノイチ
閠	ウルウドシノウルウノイタイジ
関	カンケイ ノ カン，セキ
閣	テンシュカク ノ カク
閤	タイコウキ ノ コウ
閥	ハバツ ノ バツ
閧	コウ，モンガマエニキョウツウテンノキョウ
閨	ケイボウノケイ，ネヤ
閭	リョ，モンガマエニオフロノロ
閲	エツランスル ノ エツ
閹	エン，モンガマエニキソクエンエンノエン
閻	エンマサマノエン
閼	フサグヲイミスルモンガマエノアツ
閾	イキ，モンガマエニアルイハノアル
闃	ケキ，モンガマエニモクテキノモクノシタニイヌ
闇	クラヤミ ノ ヤミ
闊	ウカツナノカツ
闌	ラン，ハランバンジョウノランノツクリ
闍	アジャリノジャ
闔	コウ，モンガマエニキョネンノキョニサラ
闕	ケイバツノケッショノケツ
闖	チンニュウスルノチン，モンガマエニウマ
闘	トウギュウシ ノ トウ，タタカウ
關	カンケイスルノカン，セキノキュウジ
闡	セン，モンガマエニタンジュンナノタンノキュウジ
闢	テンチカイビャクノビャク
闥	タツ，モンガマエニハイタツノタツ
阜	ギフケン ノ フ，オカ
阡	セン，コザトヘンニカンスウジノセン
阨	アイ，コザトヘンニヤクドシノヤク
阪	オオサカ ノ サカ，ハン
阮	ゲン，コザトヘンニガンタンノガン
阯	シ，コザトヘンニキンシスルノシ
防	ヨボウスル ノ ボウ，フセグ
阻	ソシスル ノ ソ，ハバム
阿	アミダブツ ノ ア
陀	アミダブツ ノ ダ
陂	ハ，コザトヘンニケガワノカワ
附	コザトヘンノ ツイタ フゾク ノ フ
陋	ガンメイコロウノロウ
陌	ハク，コザトヘンニカンスウジノヒャク
降	ユキガフル ノ フル，コウ
陏	ダ，コザトヘンニユウメイジンノユウ
限	ゲンカイ ノ ゲン，カギル
陛	ヘイカ ノ ヘイ
陜	セン，コザトヘンニセマイノキュウジノツクリ
陝	チュウゴクノセンセイショウノセン
陞	ショウ、コザトヘンニイッショウビンノショウノシタニドヨウビノド
陟	チョク、コザトヘンニアルクノキュウジ
院	ニュウインスル ノ イン
陣	シュツジンスル ノ ジン
除	ジョガイ ノ ジョ，ノゾク
陥	オチイル，カンラク ノ カン
陦	トウ、コザトヘンニコトブキ
陪	バイシンイン ノ バイ
陬	ソウ、コザトヘンニシュトクスルノシュ
陰	インキナ ノ イン，カゲ
陲	スイ、コザトヘンニスイチョクノスイ
陳	チンレツスル ノ チン
陵	キュウリョウチ ノ リョウ，ミササギ
陶	トウゲイカ ノ トウ
陷	オチイル，カンラクノカンノキュウジ
陸	リクジョウ ノ リク
険	ボウケン ノ ケン，ケワシイ
陽	タイヨウケイ ノ ヨウ
隅	ヨスミ ノ スミ，グウ
隆	リュウキスル ノ リュウ
隈	クマ，カイワイ ノ ワイ
隊	グンタイ ノ タイ
隋	ケンズイシノズイ
隍	コウ、コザトヘンニコウタイシノコウ
階	カイダンヲ ノボル ノ カイ
随	ズイヒツ ノ ズイ
隔	カンカク ノ カク，ヘダタリ
隕	インセキノイン、オチル
隗	カイ、コザトヘンニオニ
隘	アイロノアイ、セマイ
隙	スキマ ノ スキ，ゲキ
際	ジッサイ ノ サイ
障	ショウガイブツ ノ ショウ
隠	インキョスル ノ イン，カクレル
隣	トナリ，リンジン ノ リン
隧	トンネルヲイミスルスイドウノスイ
隨	ズイヒツノズイノキュウジ
險	ボウケンカノケンノキュウジ
隰	シツ、コザトヘンニシメッポイノキュジノツクリ
隱	イン、カクレルノキュウジ
隲	シツ、コザトヘンニスコシノシタニバシャノバ
隴	リョウ、コザトヘンニキョウリュウノリュウノキュウジ
隶	イ、ドレイカイホウノレイノツクリ
隷	ドレイカイホウ ノ レイ
隸	レイ、ドレイカイホウノレイノキュウジ
隹	スイ、ブシュノフルトリ
隻	フネイッセキ ノ セキ
隼	トリ ノ ハヤブサ
雀	スズメ，ジャク
雁	ワタリドリ ノ ガン，カリ
雄	オスメス ノ オス，ユウ
雅	ユウガ ノ ガ，ミヤビ
集	シュウゴウスル ノ シュウ，アツマル
雇	ヤトウ，コヨウスル ノ コ
雉	トリノキジ、チ
雋	フルトリノシタニオウトツノオウノシタ１カクヲトッタモノ
雌	オスメス ノ メス，シ
雍	シンノヨウセイテイノヨウ
雎	ショ、ナオカツノカツノミギニフルトリ
雑	ザツオン ノ ザツ
雕	チョウ、シュウヘンノシュウノミギニフルトリ
雖	イエドモ
雙	ソウガンキョウノソウノキュウジ
雛	ヒナマツリ ノ ヒナ
雜	ザツオンノザツノイキュウジ
離	ハナレル，リリク ノ リ
難	コンナン ノ ナン，ムズカシイ
雨	アメ，ウテン ノ ウ
雪	ユキダルマ ノ ユキ，セツ
雫	シズク，アメカンムリ ニ シタ
雰	フンイキ ノ フン
雲	クモノウエ ノ クモ，ウン
零	レイサイキギョウ ノ レイ
雷	カミナリ，ライウ ノ ライ
雹	ヒョウアラレノヒョウ，アメカンムリニツツム
電	デンワ ノ デン
需	ヒツジュヒン ノ ジュ
霄	ショウ、アメカンムリニショウゾウガノショウ
霆	テイ、アメカンムリニキュウテイブンガクノテイ
震	ジシン ノ シン，フルエル
霈	ハイ、アメカンムリニハイゼンタルノハイ
霊	レイエン ノ レイ，タマ
霍	カク，アメカンムリニフルトリ
霎	ソウ、アメカンムリニメカケ
霏	ヒ、アメカンムリニヒジョウグチノヒ
霑	テン、アメカンムリニサンズイニドクセンスルノセン
霓	ゲイ、アメカンムリニジドウセイトノジノキュウジ
霖	リンウノリン、アメエカンムリニサンリンノリン
霙	ミゾレ、アメカンムリニエイユウノエイ
霜	シモバシラ ノ シモ
霞	ハルガスミ ノ カスミ
霤	リュウ、アメカンムリニリュガクノリュウ
霧	ノウム ノ ム，キリ
霪	イン、アメカンムリニインランノイン
霰	アラレ、アメカンムリニサンンポスルノサン
露	ロシュツ ノ ロ，ツユ
霸	セイハスルノハノキュウジ
霹	セイテンノヘキレキノヘキ
霽	セイ、アメカンムリニイッセイシャゲキノセイノキュウジ？
霾	バイ、アメカンムリニムジナヘンニサトガエリノサト
靂	セイテンノヘキレキノレキ
靄	アサモヤノモヤ
靆	タイ、クモノミギニタイホジョウノタイ
靈	レイエンノレイ、タマノキュウジ
靉	アイ、クモノミギニアイスルノアイ
青	アオイ，セイシュン ノ セイ
靖	ヤスクニジンジャ ノ ヤス
静	レイセイ ノ セイ，シズカ
靜	レイセイノセイ、シズカノキュウジ
非	ヒジョウグチ ノ ヒ
靠	コウ，ツゲルノシタニヒジョウグチノヒ
靡	フウビスルノビ，ナビク
面	ジメン ノ メン
靤	ホウ，ジメンノメンノミギニツツム
靦	テン、ジメンノメンノミギニケンブツスルノケン
靨	エクボ、エンセイカンノエンノシタニジメンノメン
革	カクメイ ノ カク
靫	ウツボカズラノウツボ
靭	キョウジンナ ノ ジン
靱	キョウジンナノジンノイタイジ
靴	クツシタ ノ クツ，カ
靹	ドウ，カワヘンニコクナイノナイ
靺	マツ，カワヘンニネンマツノマツ
靼	ダッタンジンノタン
鞁	ヒ，カワヘンニケガワノカワ
鞄	カバン
鞅	オウ，カワヘンニチュウオウノオウ
鞆	トモ、カワヘンニコウオツヘイノヘイ
鞋	ワラジノニモジメ，カイ
鞍	アンバ ノ アン，クラ
鞏	キョウ、キョウノココロノカワリニカクメイノカク
鞐	コハゼ、カワヘンニウエシタ
鞘	カタナ ノ サヤ，ショウ
鞜	トウ，カワヘンニミズノシタニニチヨウビノニチ
鞠	ケマリ ノ マリ，キク
鞣	ナメス，ジュウ
鞦	シュウ，カワヘンニキセツノアキ
鞨	カツ、カワヘンニカッショクノカツノツクリ
鞫	キク，カワヘンニツツミガマエノナカニゴンベン
鞭	キョウベンヲトル ノ ベン，ムチ
鞳	トウ、カワヘンニゴジュウノトウノトウノツクリ
鞴	フイゴ，カワヘンニジュンビスルノビノツクリ
韃	ダッタンジンノタツ
韆	セン，カワヘンニサセンスルノセン
韈	ベツ，カワヘンニケイベツスルノベツ
韋	イダテンノイ
韓	カンコクジン ノ カン
韜	リクトウサンリャクノトウ
韭	ショクブツノニラノセイジ
韮	ショクブツ ノ ニラ
韲	ナマスヲイミスルセイノイタイジ
音	オト，オンガク ノ オン
韵	ヨインガノコルノインノイタイジ
韶	ショウ、オンガクノオンニマネクノツクリ
韻	ヨインガノコル ノ イン
響	オンキョウ ノ キョウ，ヒビク
頁	ページ
頂	チョウテン ノ チョウ，イタダキ
頃	コロアイ ノ コロ
項	コウモク ノ コウ，キョウツウコウ ノ コウ
順	ジュンバン ノ ジュン
須	ヒッス ノ ス，スベカラク
頌	ショウシュンノショウ，オオヤケニページ
頏	コウ，テイコウスルノコウノツクリノミギニページ
預	ヨキン ノ ヨ，アズケル
頑	ガンバル ノ ガン
頒	ハンプスル ノ ハン
頓	セイトンスル ノ トン
頗	スコブル
領	ダイトウリョウ ノ リョウ
頚	クビ，ケイ
頡	ケツ，ダイキチノキチニページ
頤	オトガイ
頬	ホオヅエ ノ ホオ
頭	アタマ，ズツウ ノ ズ
頴	スグレルヲ イミスル エイ，ホサキ，シメス
頷	ウナズク，ガン
頸	ケイツイノケイ，クビ
頻	ヒンパンナ ノ ヒン
頼	タノム，イライ ノ ライ
頽	タイハイテキナニタイ，ハゲヤマノハゲノミギニページ
顆	カリュウノカ，ツブ
顋	エラ，フシギノシノミギニページ
題	シュクジュダイ ノ ダイ
額	キンガク ノ ガク，ヒタイ
顎	アゴ，ガク
顏	カオ，ガンメンノガンノキュウジ
顔	カオイロ ノ カオ，ガン
顕	ケンビキョウ ノ ケン，アキラカ
願	ガンボウ ノ ガン，ネガウ
顛	コト ノ テンマツ ノ テン
類	ジンルイ ノ ルイ
顧	コモン ノ コ，カエリミル
顫	セン，ブツダンノダンノツクリノミギニページ
顯	ケンビキョウノケンノキュウジ
顰	ヒンシュクヲカウノヒン
顱	ロ，ハゼノキノハゼノツクリノミギニページ
顳	ジョウ，ミミミッツノミギニページ
顴	ケン，カンヅメノカンノキュウジノツクリノミギニページ
風	カゼ，タイフウ ノ フウ
颪	オロシ，ジョウゲノシタノシタニカゼ
颯	サッソウトシタノサツ
颱	タイフウヲイミスルタイ，カゼノミギニダイドコロノダイ
颶	グ，カゼノミギニドウグノグ
飃	ヒョウヒョウトシタノヒョウノイタイジ，カゼノミギニトウヒョウスルノヒョウ
飄	ヒョウヒョウトシタノヒョウ，カゼノヒダリニトウヒョウスルノヒョウ
飆	ツムジカゼ，ヒョウ，カゼノヒダリニイヌミッツ
飛	ヒコウキ ノ ヒ，トブ
飜	ホンヤクスルノホンノイタイジ
食	タベル，キュウショク ノ ショク
飢	キガ ノ キ，ウエル
飩	ドン，ウドンノニモジメ
飫	ヨ，アキル，ショクヘンニヒヨクナトチノヨクノツクリ
飭	チョク，ショクヘンニカタカナノノ，ヨコボウニチカラ
飮	インリョウスイノイン，ノムノキュウジ
飯	ゴハン ノ ハン，メシ
飲	ミズヲノム ノ ノム，イン
飴	ミズアメ ノ アメ
飼	シイク ノ シ，カウ
飽	アキル，ホウワ ノ ホウ
飾	ソウショクヒン ノ ショク，カザリ
餃	ギョーザノイチモジメ
餅	モチツキ ノ モチ
餉	ショウ，ショクヘンニムカウ
養	エイヨウ ノ ヨウ，ヤシナウ
餌	エサ，エヅケ ノ エ
餐	バンサン ノ サン
餒	ダイ，ショクヘンニダキョウスルノダ，ウエル
餓	ガシスル ノ ガ，ウエル
餔	ホ，クラウ，ショクヘンニシジンノトホノホ
餘	ヨユウノヨ，アマルノキュウジ
餝	ショク，カザルノイタイジ，ショクヘンニホウコウザイノホウ
餞	ハナムケ，センベツノセン
餠	モチツキノモチノキュウジ
餡	クズアンノアン
餤	タン，クラウ，ショクヘンニホノオ
館	トショカン ノ カン
餬	コ，カユ，ショクヘンニクロコショウノコ
餮	テツ，ムサボル
餽	キ，マツル，ショクヘンニオニ
餾	リュウ，ムス，ショクヘンニリュウガクノリュウ
饂	ドン，ウドンノイチモジメ
饅	マンジュウノマン
饉	キキンニミマワレルノキン
饋	キ，オクル，ショクヘンニキチョウヒンノキ
饌	セン，ソナエル，ショクヘンニエラブノツクリ
饐	イ，スエル
饑	キキンニミマワレルノキ，ヒダルイ
饒	ジョウゼツノジョウ，ユタカ
饕	トウ，ムサボル
饗	キョウエン ノ キョウ，モテナス
首	シュト ノ シュ，クビ
馗	ショウキサマノキ
馘	カクシュスルノカク，クビヘンニアル
香	コウシンリョウ ノ コウ，カオリ
馥	フクイクタルノフク，カオリ
馨	ジンメイ ノ カオル，ケイ，カグワシイ
馬	ウマ，バシャ ノ バ
馭	ギョシャノギョ，ウマヘンニマタ
馮	ヒョウ，タノム，ニスイニウマ
馳	ゴチソウ ノ チ，ハセル
馴	カイナラス ノ ナラス，ジュン
馼	ブン，ウマヘンニサクブンノブン
駁	ハンバクスル ノ バク
駄	ダガシ ノ ダ
駅	エキビル ノ エキ
駆	ヨンリンクドウ ノ ク，カケル
駈	カケル，ウマヘン ニ オカ
駐	チュウシャジョウ ノ チュウ
駑	ドバノド，ヤッコノシタニウマ
駒	コマ，ウマヘン ニ ハイク ノ ク
駕	ガ，リョウガスル ノ ガ
駘	シュンプタイトウノタイ
駛	シ，ハセル，ウマヘンニレキシノシ
駝	ドウブツノラクダノダ
駟	シ，ウマヘンニカンスウジノヨン
駢	ヘン，ウマヘンニヘイヨウスルノヘイノツクリ
駭	ガイ，オドロク，ウマヘンニジュウニシノイノシシ
駮	ハク，ウマヘンニマジワル
駱	ドウブツノラクダノラク
駲	ウマヘンニキュウシュウチホウノシュウ
駸	シン，ウマヘンニシンリャクスルノシンノツクリ
駻	カンバノカン，アラウマ
駿	シュンメ ノ シュン
騁	テイ，ハセル，ウマヘンニショウヘイスルノヘイノツクリ
騅	スイ，ウマヘンニフルトリ
騎	キヘイタイ ノ キ
騏	キリンノキ，ウマヘンニソノ
騒	サワグ，ソウオン ノ ソウ
験	ニュウガクシケン ノ ケン
騙	ダマス
騨	ヒダタカヤマ ノ ダ
騫	ケン，サムイノシタニテンノカワリニウマ
騰	フットウスル ノ トウ
騷	サワグ，ソウオンノソウノキュウジ
騾	ドウブツノラバノラ
驀	バクシンスルノバク
驂	サン，ウマヘンニサンカスルノサン，マイルノキュウジ
驃	ヒョウ，ウマヘンニトウヒョウスルノヒョウ
驅	ヨンリンクドウノク，カケルノキュウジ
驍	ウマヘンニギョウシュンノギョウノキュウジ
驕	キョウマンナノキョウ，オゴル
驗	シケンヲウケルノケンノキュウジ
驚	オドロク，キョウタン ノ キョウ
驛	エキビルノエキノキュウジ
驟	シュウウノシュウ，ウマヘンニジュラクダイノジュ
驢	ドウブツノロバノロ
驤	ジョウ，ウマヘンニユズルノツクリノキュウジ
驥	キビニフスノキ
驩	カン，ウマヘンニカンボクノカン
驪	レイ，ウマヘンニウルワシイ
驫	ヒョウ，ウマガミッツ
骨	ガイコツ ノ コツ，ホネ
骭	カン，ホネヘンニアセノツクリ
骰	トウ，ホネヘンニナゲルノツクリ
骸	ガイコツ ノ ガイ，ムクロ
骼	カク，ホネヘンニゴウカクノカクノツクリ
髀	ヒ，ホネヘンニイヤシイ
髄	セキズイ ノ ズイ
髏	ドクロノロ
髑	ドクロノドク
髓	セキズイノズイノキュウジ
體	カラダ，タイイクノタイノキュウジ
高	タカイ，サイコウ ノ コウ
髞	ソウ，タカイヒクイノタカイニアヤツルノツクリ
髟	ヒョウ，カミガシラ
髢	テイ，カミガシラニナリ，カモジ
髣	ホウフツノホウ，カミガシラニセイホウケイノホウ
髦	ボウ，カミガシラニケイトノケ
髪	カミノケ ノ カミ，ハツ
髫	チョウ，カミガシラニマネクノツクリ
髭	クチヒゲ ノ ヒゲ
髮	カミノケノカミノキュウジ
髯	ゼン，ホウヒゲ
髱	ホウ，カミガシラニツツム
髴	ホウフツノフツ，カミガシラニフットウスルノフツノツクリ
髷	キョク，マゲ，カミガシラニマゲル
髻	ケイ，カミガシラニダイキチノキチ
鬆	ショウ，カミガシラニマツノキノマツ
鬘	マン，カミガシラニマンダラノマン
鬚	シュ，ヒゲ，カミガシラニヒッスノス
鬟	カン，カミガシラニジュンカンスルノカンノツクリ
鬢	ビン，カミガシラニライヒンノヒン
鬣	リョウ，カミガシラニリョウジュウノリョウノキュウジノツクリ
鬥	トウ，ブシュノトウガマエ
鬧	ドウ，トウガマエニイチバノイチ
鬨	トキノコエヲアゲルノトキ
鬩	ゲキ，トウガマエニニラムノツクリ
鬪	トウギュウシノトウノキュウジ，タタカウ
鬮	キュウ，トウガマエニドウブツノカメノキュウジ
鬯	チョウ，ブシュノニオイザケ
鬱	ユウウツナノウツ
鬲	カク，ヘダタリノツクリ
鬻	シュク，カユノシタニヘダテルノツクリ
鬼	オニ，キュウケツキ ノ キ
魁	キョカイ ノ カキ，サキガケ
魂	タマシイ，シンコン ノ コン
魃	ヒデリヲイミスルカンバツノバツ
魄	ハク，シロヘンニオニ
魅	ミリョク ノ ミ
魍	チミモウリョウノモウ
魎	チミモウリョウノリョウ
魏	ギシワジンデンノギ
魑	チミモウリョウリョウノチ
魔	マホウ ノ マ
魘	エンセイカンノエンノシタニオニ
魚	サカナ，キンギョ ノ ギョ
魯	ロ，サカナ ノ シタニ ニチヨウビ ノ ニチ
魴	サカナノホウボウノホウ，ウオヘンニオヤカタノカタ
鮃	ヒラメ，ウオヘンニタイラ
鮎	アユ，サカナヘン ニ ウラナウ
鮑	アワビ，ウオヘンニツツム
鮒	フナ，サカナヘン ニ ツケル
鮓	スシ，ウオヘンニサクブンノサクノツクリ
鮖	カジカ，ウオヘンニイシ
鮗	コノシロ，ウオヘンニフユ
鮟	サカナノアンコウノアン，ウオヘンニヤスイ
鮠	サカナノハヤ，ウオヘンニアブナイ
鮨	スシ，ウオヘンニウマイ
鮪	マグロ，サカナヘン ニ アル
鮫	サメ，サカナヘン ニ マジワル
鮭	サケ，サカナヘン ニ ツチ フタツ
鮮	シンセンナ ノ セン，アザヤカ
鮴	サカナノゴリ，ウオヘンニヤスム
鮹	タコ，ウオヘンニショウゾウガノショウ
鯀	コン，ウオヘンニケイレツノケイ
鯆	ホ，ウオヘンニシジンノトホノホ
鯉	コイノボリ ノ コイ
鯊	サカナノハゼ，サンズイニスクナイノシタニウオ
鯏	アサリ，ウオヘンニケンリノリ
鯑	カズノコ，ウオヘンニマレ
鯒	サカナノコチ，ウオヘンニオケノツクリ
鯔	サカナノボラ，ウオヘンニマガリガワノシタニタンボノタ
鯖	サバ，サカナヘン ニ アオ
鯛	サカナ ノ タイ
鯡	ヒ，ウオヘンニヒジョウグチノヒ
鯢	ゲイ，ウオヘンニニラムノツクリ
鯣	スルメ，ウオヘンニボウエキフウノエキ
鯤	コン，ウオヘンニコンチュウノコン
鯨	クジラ，ホゲイ ノ ゲイ
鯰	ナマズ，ウオヘンニザンネンノネン
鯱	サカナノシャチ
鯲	ドジョウ，ウオヘンニナニナニニオイテノオ
鯵	アジ，サカナヘン ニ マイル
鰄	イ，ウオヘンニイゲンガアルノイ
鰆	サワラ，ウオヘンニハル
鰈	サカナノカレイ
鰉	コウ，ウオヘンニコウタイシノコウ
鰊	サカナノニシン，レン
鰌	ドジョウ，ウオヘンニシュウチョウサンノシュウ
鰍	カジカ，ウオヘン ニ アキ
鰐	ドウブツ ノ ワニ
鰒	フグ，ウオヘンニハラノツクリ
鰓	エラ，ウオヘンニオモウ
鰔	カン，ウオヘンニハリキュウノハリノツクリ
鰕	ウオヘンノエビ，カ
鰛	オン，ウオヘンニオンセンノオンノツクリ
鰡	ウオヘンニリュウガクノリュウ，ボラ
鰤	サカナノブリ
鰥	カン，オトコヤモメノヤモオ
鰭	サカナ ノ ヒレ
鰮	オン，ウオヘンニトラワレビトノシュウノシタニサラ
鰯	イワシ，サカナヘン ニ ヨワイ
鰰	サカナノハタハタ，ウオヘンニカミサマノカミ
鰲	ゴウ，ゴウマンノゴウノツクリノシタニサカナ
鰹	カツオ，ウオヘン ニ カタイ
鰺	サカナノアジノイタイジ，カタカナノムガミッツ
鰻	ウナギ
鰾	ウキブクロ，ウオヘンニトウヒョウスルノヒョウ
鱆	ショウ，ウオヘンニブンショウヲカクノショウ
鱇	サカナノアンコウノコウ，ウオヘンニイエヤスノヤス
鱈	タラ，サカナヘン ニ ユキ
鱒	マス，サカナヘン ニ ソンケイスル ノ ソン
鱗	ウロコ，ヘンリン ノ リン
鱚	サカナノキス，ウオヘンニヨロコブ
鱠	ウオヘンノナマス
鱧	サカナノハモ，ウオヘンニユタカ
鱶	サカナノフカ，ウオヘンニヤシナウ
鱸	サカナノスズキ
鳥	トリ，ヤチョウ ノ チョウ
鳧	ミズドリノケリ，トリノシタニツクエノツクリ
鳩	トリ ノ ハト
鳫	ガン，ガンダレニトリ
鳬	ミズドリノケリ，トリノヨツテンノカワリニツクエノツクリ
鳰	ミズトリノニオ，ニュウガクノニュウニトリ
鳳	ホウオウ ノ オウ，オオトリ
鳴	ヒメイヲアゲル ノ メイ，ナク
鳶	トリ ノ トビ
鴃	トリヘンニカイテキノカイ，モズ
鴆	チン，シズムノツクリノミギニトリ
鴇	トリ ノ トキ
鴈	ガン，ガンダレニニンベンニトリ
鴉	キバニトリ，カラス
鴎	カモメ
鴒	セキレイノレイ
鴕	ダ，トリヘンニブッダノダノツクリ
鴛	エンオウ ノ エン，オシドリ
鴟	シ，テイコウスルノテイノツクリノミギニトリ
鴣	トリノシャコノコ，チュウコシャノコノミギニトリ
鴦	エンオウノオウ，オシドリ
鴨	トリ ノ カモ
鴪	イツ，アナヲホルノアナノミギニトリ
鴫	シギヤキ ノ シギ
鴬	ウグイス
鴻	コウコク ノ ココロザシ ノ コウ，オオトリ
鴾	ボウ，シャカムニノムノミギニトリ
鴿	コウ，ゴウカクノゴウノミギニトリ
鵁	コウ，コウツウノコウノミギニトリ
鵄	シ，ゲシノシノミギニトリ
鵆	ギョウガマエノナカニトリ，チドリ
鵈	ミミヘンニトリ，トビ
鵐	ブ，ジンジャノミコノフノミギニトリ
鵑	ケン，キヌイトノキヌノツクリノミギニトリ
鵙	ケキ，カイヘンニトリ
鵜	ウノミニスル ノ ウ
鵝	ガ，ガマンノガノミギニトリ，ガチョウノガ
鵞	ガ，ガマンノガノシタニトリ，ガチョウノガ
鵠	コウコク ノ ココロザシ ノ コク
鵡	トリ ノ オウム ノ ム
鵤	ツノヘンニトリ，イカルガ
鵬	オオトリ，ホウユウ ノ ホウニトリ
鵯	ヒヨドリ，ヒクツナノヒノミギニトリ
鵲	カササギ，ムカシノミギニトリ
鵺	ヨゾラノヨノミギニトリ，ヌエ
鶇	ツグミ，ヒガシノミギニトリ
鶉	トリノウズラ
鶏	ニワトリ，ヨウケイ ノ ケイ
鶚	ガク，ワニノツクリノミギニトリ，ミサゴ
鶤	コン，グンタイノグンノミギニトリ
鶩	ボク，ムジュンノムトノブンノシタニトリ
鶫	ツグミ，ニシンノツクリノミギニトリ
鶯	ウグイス，アタマニカヨウビノカガフタツ
鶲	オウ，オキナノミギニトリ
鶴	トリ ノ ツル
鶸	ジャク，ヨワイノミギニトリ，ヒワ
鶺	セキレイノセキ
鶻	コツ，ホネノミギニトリ
鷁	ゲキ，リエキノエキノミギニトリ，アオサギ
鷂	テン，マゴコロノマノミギニトリ
鷄	ニワトリノキュウジ
鷆	テン，マゴコロノマノキュウジノミギニトリ
鷏	テン，マゴコロノマノミギニトリ
鷓	トリノシャコノシャ，ショミンノショノミギニトリ
鷙	シ，シツジノシツノシタニトリ
鷦	ショウ，コゲルノミギニトリ
鷭	バン，バンゴウノバンノミギニトリ
鷯	リョウ，ドウリョウノリョウノツクリノミギニトリ
鷲	トリ ノ ワシ
鷸	イツ，タチバナノツクリノミギニトリ，シギ
鷹	トリ ノ タカ
鷺	シラサギ ノ サギ
鷽	ガク，ガクカンムリノキュウジタイノシタニトリ
鸚	トリノオウムノオウ
鸛	トリノコウノトリ，カン
鸞	シンランショウニンノラン
鹵	ロカクノロ，シオ
鹸	コナセッケン ノ ケン
鹹	カンスイコノカン，カライ，ロカクノロノミギニハリキュウノハリノツクリ
鹽	シオノキュウジ，エン
鹿	ドウブツ ノ シカ
麁	ソ，アライ，カタカナノクノシタニシカ
麈	シュ，シカノシタニシュジンコウノシュ
麋	ビ，シカノシタニコメ
麌	オジカ，ゴ，シカノシタニゴフクヤノゴノキュウジケイ
麑	カノコ，ゲイ，シカノシタニジドウセイトノジノキュウジ
麒	キリンジノキ，シカノミギニソノ
麓	サンロク ノ ロク，フモト
麕	ノロジカノノロ，シカノシタニクニガマエニノギヘンノノギ
麗	カレイナ ノ レイ，ウルワシイ
麝	ジャコウジカノジャ，シカノシタニハンシャノシャ
麟	キリン ノ リン
麥	ムギノキュウジ
麦	ムギチャ ノ ムギ
麩	オフノフ，ムギノキュウジニオット
麪	メンルイノメンノイタイジ
麭	ホウ，ムギノキュウジニツツム
麸	オフノフ，ムギニオット
麹	コウジキン ノ コウジ
麺	メンルイ ノ メン
麻	マスイ ノ マ，アサ
麼	モ，マスイノマノシタニイトガシラ
麾	イエヤスキカノキ，マスイノマノシタニウモウノモウ
麿	ウタマロ ノ マロ
黄	キイロ ノ キ，オウ
黌	ショウヘイコウノコウ
黍	コクモツ ノ キビ，ショ
黎	レイメイキノレイ
黏	ネバル，ネン，キビヘンニドクセンスルノセン
黐	トリモチノモチ，キビヘンニハナレルノツクリ
黒	コクバン ノ コク，クロ
黔	クロイ，ケン，クロイノミギニイマ
默	チンモクスルノモク，ダマルノキュウジ
黙	チンモク ノ モク，ダマル
黛	マユズミ
黜	シリゾケル，チュツ，クロノミギニデル
黝	アオグロイ，ユウ，クロノミギニオサナイ
點	テンスウノテンノキュウジ
黠	カツ，クロノミギニダイキチノキチ
黥	ゲイ，イレズミ，クロノミギニトウキョウノキョウ
黨	ヨトウヤトウノトウノキュウジ
黯	クライ，アン，クロノミギニオンガクノオン
黴	カビ，バイキンノバイ
黶	ホクロ，エン
黷	ケガス，トク，クロノミギニハンバイノバイノキュウジ
黹	チ，ブシュノフツ
黻	ヒザカケヲイミスルフツ
黼	ヌイトリノモヨウヲイミスルフ
黽	ビン，ナワノキュウジノツクリ
鼇	オオガメヲイミスルゴウ
鼈	ベッコウアメノベツ
鼎	テイダン ノ テイ，カナエ
鼓	タイコ ノ コ，ツヅミ
鼕	トウ，ツヅミノシタニフユ
鼠	ネズミ
鼡	ネズミノイタイジ
鼬	ドウブツノイタチ
鼻	ハナカゼ ノ ハナ
鼾	イビキ
齊	イッセイシャゲキノセイノキュウジ
齋	ショサイノサイノキュウジ
齎	モタラス，セイ
齏	ナマスヲイミスルセイ
齒	ハブラシノハノキュウジ
齔	シン，ハノキュウジノミギニカタカナノヒ
齟	ソゴヲキタスノソ
齠	チョウ，ハノキュウジノミギニショウシュウレイジョウノショウ
齡	ネンレイノレイノキュウジ
齢	ネンレイ ノ レイ
齣	コマ，ハノキュウジノミギニハイクノク
齦	ギン，ハグキ
齧	ゲッシルイノゲツ，カジル
齪	アクセクスルノセク，ハノキュウジノミギニアシ
齬	ソゴヲキタスノゴ
齲	ウシノウ，ムシバ
齶	アゴ，ガク，ハノキュウジノミギニガクゼントスルノガクノツクリ
齷	アクセクスルノアク，ハノキュウジノミギニオクジョウノオク
龍	タツ，リュウ ノ キュウジ
龕	ガンドウノガン，ゴウカクノゴウノシタニリュウ
龜	ドウブツノカメノキュウジ
龝	アキ，ノギヘンニカメノキュウジ
龠	ブシュノヤク，フエ
！	カンタンフ
＃	シャープ
＄	ドル
％	パーセント
＆	アンド
（	カッコ
）	トジカッコ
＊	アスタリスク
＋	プラス
，	コンマ
－	マイナス
．	ピリオド
／	スラッシュ
０	ゼロ
１	イチ
２	ニ
３	サン
４	ヨン
５	ゴ
６	ロク
７	ナナ
８	ハチ
９	キュウ
：	コロン
；	セミコロン
＜	ショウナリ
＝	イコール
＞	ダイナリ
？	クエスチョン
＠	アットマーク
Ａ	エイ アニマル
Ｂ	ビー ボーイ
Ｃ	シー キャット
Ｄ	ディー デスク
Ｅ	イー エッグ
Ｆ	エフ フレンド
Ｇ	ジー ゴルフ
Ｈ	エイチ ホテル
Ｉ	アイ インク
Ｊ	ジェイ ジャパン
Ｋ	ケイ キッチン
Ｌ	エル ラブ
Ｍ	エム マイク
Ｎ	エヌ ノベンバー
Ｏ	オー オープン
Ｐ	ピー パパ
Ｑ	キュー クエスチョン
Ｒ	アール ルーム
Ｓ	エス スポーツ
Ｔ	ティー タイム
Ｕ	ユー ユージュアリー
Ｖ	ブイ ビデオ
Ｗ	ダブリュー ウィンドウ
Ｘ	エックス エックスセン
Ｙ	ワイ ヤング
Ｚ	ゼット ズー
［	カクカッコ
＼	バックスラッシュ
］	トジカクカッコ
＾	ベキジョウ
＿	アンダーライン
｀	アクサングラーブ
ａ	エイ アニマル
ｂ	ビー ボーイ
ｃ	シー キャット
ｄ	ディー デスク
ｅ	イー エッグ
ｆ	エフ フレンド
ｇ	ジー ゴルフ
ｈ	エイチ ホテル
ｉ	アイ インク
ｊ	ジェイ ジャパン
ｋ	ケイ キッチン
ｌ	エル ラブ
ｍ	エム マイク
ｎ	エヌ ノベンバー
ｏ	オー オープン
ｐ	ピー パパ
ｑ	キュー クエスチョン
ｒ	アール ルーム
ｓ	エス スポーツ
ｔ	ティー タイム
ｕ	ユー ユージュアリー
ｖ	ブイ ビデオ
ｗ	ダブリュー ウィンドウ
ｘ	エックス エックスセン
ｙ	ワイ ヤング
ｚ	ゼット ズー
｛	チュウカッコ
｜	タテセン
｝	トジチュウカッコ
～	ナミセン
｡	マル
｢	カギ
｣	トジカギ
､	テン
･	ナカテン
ｦ	ヲワリ ノ ヲ
ｧ	チイサイ アサヒ ノ ア
ｨ	チイサイ イチゴ ノ イ
ｩ	チイサイ ウサギ ノ ウ
ｪ	チイサイ エイゴ ノ エ
ｫ	チイサイ オオサカ ノ オ
ｬ	チイサイ ヤカン ノ ヤ
ｭ	チイサイ ユカタ ノ ユ
ｮ	チイサイ ヨット ノ ヨ
ｯ	チイサイ ツバメ ノ ツ
ｰ	チョウオン
ｱ	アサヒ ノ ア
ｲ	イチゴ ノ イ
ｳ	ウサギ ノ ウ
ｴ	エイゴ ノ エ
ｵ	オオサカ ノ オ
ｶ	カゾク ノ カ
ｷ	キッテ ノ キ
ｸ	クスリ ノ ク
ｹ	ケシキ ノ ケ
ｺ	コドモ ノ コ
ｻ	サクラ ノ サ
ｼ	シンブン ノ シ
ｽ	スズメ ノ ス
ｾ	セカイ ノ セ
ｿ	ソロバン ノ ソ
ﾀ	タバコ ノ タ
ﾁ	チキュウ ノ チ
ﾂ	ツバメ ノ ツ
ﾃ	テガミ ノ テ
ﾄ	トウキョウ ノ ト
ﾅ	ナマエ ノ ナ
ﾆ	ニホン ノ ニ
ﾇ	ヌリエ ノ ヌ
ﾈ	ネズミ ノ ネ
ﾉ	ノハラ ノ ノ
ﾊ	ハガキ ノ ハ
ﾋ	ヒカリ ノ ヒ
ﾌ	フトン ノ フ
ﾍ	ヘイワ ノ ヘ
ﾎ	ホケン ノ ホ
ﾏ	マッチ ノ マ
ﾐ	ミカン ノ ミ
ﾑ	ムシ ノ ム
ﾒ	メガネ ノ メ
ﾓ	モミジ ノ モ
ﾔ	ヤカン ノ ヤ
ﾕ	ユカタ ノ ユ
ﾖ	ヨット ノ ヨ
ﾗ	ラジオ ノ ラ
ﾘ	リンゴ ノ リ
ﾙ	ルスバン ノ ル
ﾚ	レモン ノ レ
ﾛ	ロウカ ノ ロ
ﾜ	ワカメ ノ ワ
ﾝ	オシマイ ノ ン
ﾞ	ダクテン
ﾟ	ハンダクテン
￠	セント
￡	ポンド
￢	ヒテイ
￣	オーバーライン
￥	エンマーク
